ALMLA	IN
HWFG	VB
HXLJWT	NN
HWLLIM	JJ
1,776	CD
ATRIM	NN
ABZRIM	NN
FQWPIM	JJ
WQMNIM	NN
NWGDIM	JJ
MXPFIM	VB
PLJWT	NN
HWFR	VB
KPIWT	NN
RDLR	NNP
CARLJWN	NNP
MJIL	VB
MTXRIM	NN
BWTIW	ZVL
LBNWNIT	JJ
SPQ	NN
SPR	NN
AWKZBW	VB
QWRCIM	VB
BIRWT	NNT
SPI	NNP
MRKZM	NN
SPD	VB
MRKZI	JJ
SPG	VB
FIJTIT	JJ
BXINWT	NN
IXL	VB
XPC	NNT
QFWRWT	VB
DWBRI	NNT
IXD	IN
MSWNPIM	VB
IEILH	JJ
HWSIPW	VB
JMPLRIM	NN
HTPTXWT	NN
NFALT	VB
IXS	NN
FJIINBK	NNP
CRKIHM	NN
BAIRNWBH	NNP
JNQ	NNT
FLJIM	NN
PQD	NN
RGILIM	JJ
6791	CD
KLLM	NN
MXTRT	NN
KLLI	JJ
KLLH	VB
QWFR	VB
KLLW	VB
MIDLSBWRW	NNP
TQWPWT	NN
MTAPFRT	VB
CWJJW	VB
XWMRI	NNT
BEJ	VB
FIRTW	VB
BEL	NNT
EDKWNIM	NN
XDWT	JJ
AMRIQAI	JJ
ITARK	VB
BED	IN
BKIRWT	JJ
TWFLM	VB
IQCWR	VB
MZLNW	NN
LHJEWT	VB
BET	NN
ITARX	VB
EMNWAL	NNP
NPGFW	VB
GLGWLIM	NN
INHLW	VB
BIRT	NNT
MIIXLT	VB
BIRH	NN
SJWDNJIALI	JJ
ECBIM	NN
IZKWR	NNP
BIRD	NNP
IISWRIM	NN
HTXRW	VB
NWKXIWT	JJ
GRR	VB
GZEIIM	JJ
GRP	VB
IPHPIIH	JJ
MWKNIM	VB
MJWRPWT	JJ
TPRH	VB
EIRK	NN
KNISTM	NN
MANIIRWT	NN
NJIITW	NN
NWTNT	VB
GRM	VB
GRI	NNP
MFABIH	NN
MPRC	NN
BDIQWT	NNT
MFABIM	NN
SWDWT	NNT
MPRF	NN
NIGFH	VB
PIQWD	NNT
MPRJ	VB
MAWLCT	JJ
HLWWIH	NN
HLM	NN
HLL	NNP
HLK	VB
HTABDWTW	NN
PIQWX	NN
HLH	PRP
ENT	NNP
IWCRIM	NN
MLIWNR	NN
HLA	RB
DIMWIIM	NN
MELIWT	NN
FJN	NN
EWLMN	NN
EWLMM	NN
FJG	NNP
EWLMH	NN
HKRTW	NN
PRNST	NNT
EWLMW	NN
FJX	NN
GBWHWT	JJ
MSQNWT	NN
BWXR	VB
HTPTXWIWT	NN
NTWN	VB
057	CD
051	CD
052	CD
053	CD
LDMIIN	VB
MTWXH	JJ
PRWANI	JJ
HWZRMW	VB
SPWNSRIM	NN
APQJIWWIWT	NN
XSWT	NNT
MQPIDH	VB
AIPFRH	VB
QSMH	NN
KWES	JJ
NXFDW	VB
QWPCIM	NN
99	CD
98	CD
ZIRT	NNT
DWRFIM	VB
FIIQSPIR	NNP
BAWT	JJ
AIIFWWARIH	NNP
91	CD
90	CD
93	CD
92	CD
95	CD
94	CD
96	CD
FKBTI	JJ
HGIFH	VB
EZBW	VB
HSDRT	NNT
RBIEIT	JJ
EDH	NN
EDI	NNP
EDN	NNP
IMWT	NNT
LMH	QW
FPTWT	NNT
MJIP	NN
LMN	IN
PGIETW	NN
HSDRI	NNT
LMD	VB
2,162	CD
BICWR	NNT
FLBI	NNT
FERI	NNT
FERH	NN
HGDRTK	NN
HGDRTH	NN
LFWB	VB
FERW	NN
BICWE	NNT
LFWN	NN
BITM	NN
LFWJ	VB
DPI	NNT
CWRBT	JJ
LF	NNP
MTBJAT	VB
HFQEWT	NN
LB	NN
LA	RB
LN	VB
LM	NNP
LK	VB
LH	NNP
LW	IN
PALQW	NNP
MXAH	NN
MMWFK	JJ
LHCJRP	VB
LX	JJ
A	NNP
GMLAIM	NN
QWMIQAIM	NN
IAPFR	VB
LXM	NN
IIFWMH	NN
TBWDD	VB
MSPQIM	VB
AIFWR	NNT
FNWTIW	NN
MXWSN	VB
ZMINIM	JJ
CPRIRIM	NNP
MEID	VB
MIWEDWT	VB
FNWTIH	NN
AIFWM	NN
QRQE	NN
EJWP	JJ
TQWEIM	JJ
EJWR	JJT
MWMXH	NN
DWBRT	NNT
NXQRIM	VB
PWQS	NNP
MQSWWL	NNP
MNHLIM	NN
PNW	VB
TPQIDN	NN
PNI	NNT
PNH	VB
MNHLIW	NN
TNWET	NNT
LHPR	VB
EWBDI	NNT
EWBDH	NN
HIFGI	NNT
ITRWNWT	NN
KTBTK	NN
AIABQ	VB
LETIM	RB
RNSANS	NN
MNKL	NNT
QSJLIJW	NNP
KPSR	NNP
XPR	NNP
ATNIIM	JJ
PRANCSQH	NNP
NHNIM	VB
DWLPIN	NNP
EICBH	VB
EWBDT	VB
LHFTLJ	VB
MXIIBT	VB
MZEZET	JJ
PRQI	NNT
HTGLH	VB
LHFTLB	VB
ALIMH	JJ
MRWWIX	VB
LHPK	VB
NTNIHW	NNP
ISWRW	VB
MGWWNIM	JJ
MHLKIM	NN
BDIQH	NN
TKWNWTIHM	NN
TRBWTIT	JJ
MIISR	VB
GRRW	VB
NTRMIM	VB
MRQ	NN
MCWDT	NNT
MWCRI	NNT
MWFBIM	NN
FINWI	NN
MRH	JJ
MWFBIH	NN
XRPH	NN
HMBWRG	NNP
MRD	NNT
CIBWR	NN
HIGD	NN
MRB	DT
NHRG	VB
NTMLAH	VB
MKLWL	NN
TENIQ	VB
APS	CD
APP	VB
BRITH	NN
API	NNP
MQSIQAI	JJ
QIIMWT	JJ
APL	JJ
APM	NN
ITPWS	VB
IAPFRW	VB
AXRI	IN
MWLJI	MOD
AWSJRLIH	NNP
HBHIRH	VB
LINHRJ	NNP
NIBAW	VB
MWLD	NN
MPWRSMIM	JJ
2,500	CD
HBHIRW	VB
NSTIIMH	VB
ALKSNDR	NNP
MCBT	NNT
MWCBWT	VB
NHGIM	NN
IZMH	VB
HWKIX	VB
ISWD	NN
IWMIN	NN
MXZWR	NN
MDLILH	NNP
NAJS	NNP
MXZWT	NN
IZMW	VB
MFMEWTIWT	JJ
MTRWPP	VB
AIRLND	NNP
TBIET	NNT
GWRLIWT	JJ
ALQJRWNI	JJ
XWBTW	NN
DWAGIM	VB
MDAIGWT	VB
XWBTM	NN
HSMQTI	VB
MKWNIT	NN
MEDIP	VB
TBIEH	NN
IBIEW	VB
NRFMW	VB
EWPR	NNP
MSIIE	VB
NWJLIM	VB
TPSID	VB
HPCCT	NNT
83	CD
RWWIIM	VB
RAIIH	NN
IBRXW	VB
HADRT	NNT
HTMRDWT	NN
TPSIQ	VB
BRIAIM	JJ
BRLINAIT	JJ
RAIIT	NNT
MBWJX	NN
HTRIE	VB
AIGRWP	NN
AIMPRSIWNISJIIM	JJ
APIQ	NN
AIGRWT	NNT
HSITW	VB
FBEWT	NNT
GWPTW	NN
MDINTIIM	JJ
FRIRWTIT	JJ
MLAKWTIT	JJ
DBQIM	NN
PWRNWGRPI	JJ
BXRW	VB
PJMIM	NN
XLWDIM	JJ
MSKIM	VB
THWWH	VB
IFBITW	VB
NIQX	VB
DBQIT	NN
SJJISJIIM	JJ
NIQS	NNP
KSPIWT	JJ
CRWT	NN
BJWX	VB
CRWP	JJ
KWXH	NN
FMALIT	JJ
BJWN	NN
BJWI	NN
MFRDI	NNT
KWXN	NN
HAMIN	VB
FMAL	NN
MWEDWN	NN
NRTEWT	VB
MLWNAI	NN
HINDIT	JJ
QWNG	NNP
HCMDWT	NN
FWWDI	JJ
ILDWTW	NN
HWCGH	VB
XWDFI	NNT
ECRH	VB
MBNH	NN
ILDWTN	NN
ECRW	VB
PTQIM	NN
TMCA	VB
MJAPISIWT	JJ
JPILIM	NN
DIPLWMJI	JJ
HINDIM	NN
MKPR	VB
TXBWRH	NN
LHTPNWT	VB
WLDISLB	NNP
MQWR	NN
HRXIQH	VB
XWMRTH	NN
MILIWNIM	CD
MQWM	NN
AWIB	NN
SEWDIM	NN
LPRWQ	VB
SEWDIH	NNP
RAIWTIH	NN
ANGLIH	NNP
HSKIM	VB
LWTR	NNP
ZEMM	NN
TSMWNT	NNT
LPRWF	VB
ANGLIT	NN
LPRWE	VB
SEWDIT	JJ
EQWBIM	JJ
PIREWN	NNT
KWPR	NN
SISMAWTIW	NN
HNHIGH	VB
MMKR	NNT
IRWQNW	VB
AWMDN	NN
LGIJIMIT	JJ
SNIPIM	NN
QRICWT	NN
QLASI	JJ
PBRWAR	NNP
HPREH	NN
TARI	NNT
AIRE	VB
HMWNIWT	JJ
AIRH	VB
AIRI	JJ
MKHN	VB
SBLN	NN
PWCCW	VB
PGIWN	NN
TARX	VB
LHIEFWT	VB
AXRAIM	NN
FINWWH	NNP
MHLWMT	NNT
FWNA	VB
TPAWRNIT	NN
EITWNAI	NN
KIFLWN	NNT
SWPRMRQJ	NN
FWNI	NN
FWNH	JJ
MEWLH	JJ
LGIJIMIWT	JJ
IDIHM	NN
MEWLM	RB
MTLHMIM	JJ
SKNH	NN
SWGIIT	NNT
MRWKZ	JJ
MWFLMT	JJ
CEIRWT	JJ
MAWD	MOD
QICWNI	JJ
MAWS	JJ
MAWT	CDT
MIWTRWT	JJ
PAFISJIM	NN
QWNIM	VB
4.00	CD
FMETI	VB
KRJISIM	NN
TSRIJIM	NN
ZXL	NN
JXINH	NN
ARFT	NNT
LRWM	NNP
LRWC	VB
ADMTH	NN
PAFISJIT	JJ
ADMTM	NN
HTNCXWT	NNT
LFAT	VB
GBWRH	NN
DRKIM	NN
HFKIL	VB
MCWIIM	JJ
HFKIB	VB
ELBWNWT	NN
MCWIIN	JJ
ALMH	NNP
AWGWSJ	NNP
NFKX	VB
ZGWGIWT	NN
MCUX	NNP
MTLBJ	JJ
NFKR	JJ
MTNQF	NN
BHXLJ	RB
AIRWNIH	NN
HFQPTW	NN
ALMNJ	NN
AXID	JJ
BLWMNJL	NNP
DMH	NN
SWKN	NNT
SWKM	VB
DMM	NN
XWRFWT	NNT
MSDRWN	NN
FMEWN	NNP
DMW	MOD
SIMPAJIM	JJ
TLMID	NN
NWCXW	VB
HWLMWT	JJ
MJWT	NNT
LKRSM	VB
MTWNWT	JJ
SIBWB	NN
QLPIWT	NN
MJWS	NN
NZKR	VB
AWFPZH	VB
FDWT	NNT
AWFPZW	VB
SIBWT	NN
RWCIM	VB
LDAWG	VB
MGIE	VB
MGID	NNP
MSMK	NN
MGIB	VB
MFXQIH	NN
HPELT	NNT
SRJNI	NNT
MZBX	NNT
MILIJNJI	JJ
XRF	VB
XRB	NN
IXZRW	VB
MEWRH	VB
NDIRH	JJ
BPRJ	MOD
HPELH	NN
XRP	IN
HWEMDH	VB
RGILWT	JJ
KAFR	IN
HFTWLLW	VB
LHIZHR	VB
ASUA	NNP
MTXDFT	VB
MBQR	NN
NGSW	VB
NPTXW	VB
QRISJL	NNP
PSX	NNP
IIZHRW	VB
MBQF	VB
INWE	VB
PSQ	NNT
XIKITM	VB
HNA	NNP
HNC	NNP
MQBILWT	JJ
BWRSWT	NN
BCD	IN
HNH	RB
NLXMW	VB
HNM	AGR
MTMSRWT	VB
FIGEWN	NN
EDKWNI	NNT
BRHUM	NNP
TIZWT	NN
251	CD
GSWT	NNT
QIWMW	NN
MWKN	VB
HNHGWT	NN
HELAWT	NNT
CRIK	VB
HTBJA	VB
FGRIRWT	NNT
SDIN	NN
PWMBI	NN
QIWMM	NN
EIDWD	NNT
QIWMH	NN
HWGNT	VB
HRFH	VB
HIMNEWT	NN
SRJ	NN
SRI	NNP
SRN	NN
MNDJIM	NN
LHTRGF	VB
FLIXWT	NN
SRT	JJT
BMIFRIN	RB
LDQWR	VB
LNJWE	VB
RIINALDW	NNP
HFTQE	VB
NXL	VB
LHCBIE	VB
MEFHW	NN
XICWNIT	JJ
RIKJR	NNP
LWWIWT	NN
NSBL	JJ
SWBIIJIIM	JJ
IBDWQ	VB
HPSQT	NNT
NTQL	VB
MWQD	NNT
FHH	VB
NXITT	NNT
MWQI	NNP
BIJAH	VB
CLXT	NN
NXITH	NN
GIXWK	NN
PWEL	NN
FWQD	VB
AKZR	JJ
13.11	CD
LIGLI	JJ
TLK	VB
AIREH	VB
KLLIT	JJ
BINIIM	NN
AIREW	VB
ARZI	NNT
AQDXIM	NN
HPIKT	NNT
KTMI	NNT
HWKRZ	VB
TQIEH	NN
BRKTW	NN
KWXM	NN
TDEK	VB
CCIM	VB
MFME	NN
MINISJR	NNP
HEDIPW	VB
NMXQ	VB
MFMX	VB
SIMPJWMJI	JJ
DIPLWMJIIM	JJ
PNSIH	NN
MFMR	NNT
PNSIM	NN
WWLGRIWT	NN
EBD	VB
BNWIH	VB
NALCIM	VB
AWRAL	NNP
MPDUL	NNP
EBH	JJ
KTIBTW	NN
IBXRW	VB
QHIR	NNP
BWCEH	VB
LIBRLIZM	NN
EBR	VB
ETWDWTIHN	NN
QRIJRIWNIM	NN
WWLGARI	JJ
TFLWBWT	NNT
MEIINIW	NN
XIZWQ	NNT
PIINSWD	NNP
HFTDL	VB
KLKLIIM	JJ
TBJIX	VB
XARBI	NNP
PWRFT	VB
NAWMW	NN
IIRAH	VB
PWRFW	VB
DRK	NN
MMLKTIT	JJ
IIRAW	VB
XIZWI	NN
QIFWR	NN
WWTIQIM	NN
KTWBIM	VB
DRF	VB
QWLWNIALISJIWT	JJ
PDGWGIT	NN
HXLH	VB
DWDIM	NN
DRWMI	JJ
HXLT	NNT
MSLQIM	VB
HXLW	VB
IIMLJ	VB
LHTIR	VB
FLWWT	NNT
XRIPH	JJ
BWXN	VB
EITWN	NN
QCWBH	JJ
LTQN	VB
NDRF	VB
QWNSJNJINSQW	NNP
1151	CD
FRIR	NNP
MLGLGIM	VB
QRWI	VB
FRIM	NN
AWPIINIWT	JJ
JRWWLIAN	NNP
MMLKTIWT	JJ
QRWB	JJ
FRID	NNP
IRXMIAL	NNP
QLEW	VB
QHILTI	JJ
KLFHM	JJ
KLFHN	JJ
QBIEH	NN
KLFHI	JJ
034,000	CD
QBIET	NNT
TNWHL	VB
KLFHW	JJ
IRIEWT	NNT
LMEFH	RB
DNWWR	NNP
yyRRB	yyRRB
KWPIM	VB
MFWNWT	JJ
XJWPIM	NN
SWPIT	RB
MBWCEIM	VB
AXIHWD	NNP
HACT	NNT
MNHL	NNT
WWTIQI	NNT
ENII	NNT
ENIN	NN
LACIW	NNP
METH	RB
RWNAL	NNP
LLXWC	VB
AIMPRSIWNIZM	NN
MNKULI	NNT
LLXWF	VB
LCRWK	VB
DAGH	NN
IXTRW	VB
SBLWTIH	NN
IFQLW	VB
FWQDIM	VB
PWPWLRI	JJ
SMDR	NN
QJWRZH	NNP
MWRJ	JJT
PQIDWT	NNT
RIXWQ	NNT
HIBXRWTM	NN
MFRT	NNT
BRIJNIH	NNP
MTBRRT	VB
NPCE	VB
MBWSSIM	JJ
HSTDRWT	NN
EZIBTW	NN
MFMETIWT	JJ
HGIRTM	NN
MFL	NNT
EIRIH	NN
EZIBTM	NN
MWNIWT	NN
HFGI	NNT
MXLIP	VB
FKNW	NN
NIMR	NNP
FWRRT	VB
RGLI	NNT
IWEC	NN
HWBILW	VB
PSIM	NN
BRIRH	NN
RWTM	NNP
NHPK	AUX
MPH	NN
MPI	IN
MPT	NNT
MPR	VB
HWXLPH	VB
LIRWT	VB
TIAJRLIT	JJ
MKLIM	NN
HFTWLLWT	NNT
MWNX	VB
AWPWRJWNISJI	JJ
MWNW	VB
AIWMM	NN
HSPDW	NN
AIWMI	NNT
PNSIIT	NNT
MWNJ	NNP
CEQN	JJ
MWNH	VB
NFKRIM	JJ
CPWI	JJ
MWND	NNP
MWNE	VB
MEWWT	JJ
CPWN	NN
LKHN	VB
MTRXFIM	VB
EMIM	NN
PLFTINIM	NN
EZRIH	NNP
HCETW	NN
MSTIIDIM	VB
TWKNITW	NN
MWBNWT	VB
HCETM	NN
HCETI	VB
LXLWM	VB
5,191	CD
HTXIIBW	VB
HWTQPH	VB
JIWJWT	NN
PLFTINIT	JJ
EMIT	NNP
LXLWF	VB
TWRH	NNP
HTQBLW	VB
EWRK	NNT
PWLIJI	JJ
SLAX	NNP
IEFW	VB
HARKH	NN
FBUK	NNP
MWCBIM	VB
XRWJIM	JJ
IWMIIM	NN
AZRX	NN
EWRR	VB
EWRP	NN
HTQBLH	VB
DEH	NN
BIQWRIM	NN
FXQIM	NN
HWMWR	NN
LIMWDIW	NN
XZWNWTIW	NN
TWKKI	NNT
PWRENWT	NN
DRWQR	NNP
XLASQW	NNP
XFTI	VB
REIWNIT	JJ
HCLXWT	NN
LHXZIR	VB
LHXZIQ	VB
MCBIM	NN
TXNWT	NNT
MIWTRT	JJ
IBFWT	NN
MTNGDI	NNT
IWBAW	VB
PWLIN	NNP
ECBWT	NNT
MWBLET	NNT
TAWLWGIH	NN
HXLJNW	VB
NISH	VB
BWWDAI	RB
FPTW	NN
HWRDH	NN
MECMH	NN
MKFIRI	NNT
LALC	VB
MQWMH	NN
DIQJJWRH	NN
IRDNH	NNP
MIJWSIS	NN
MECMT	NNT
SLIMZIANWB	NNP
HWRDT	NNT
NISW	VB
HJLT	NNT
FPTM	NN
NTQBLH	VB
E	NNP
RAIIN	VB
MLIAH	NN
ERBIIM	JJ
KFIRH	JJ
HXLPT	NNT
HXLPH	NN
FWXRRW	VB
ZWLWJWXIN	NNP
MLIAT	NNT
RFWIWT	NN
NTQBLW	VB
LHSPID	VB
MBLI	IN
NFARH	VB
SPGW	VB
HWLKT	VB
PNITI	VB
JWENT	VB
MFPXWT	NN
XFFWT	NN
HPIC	VB
LHSPIQ	VB
SPGH	VB
MMWQMIM	VB
IPXT	VB
DEKH	VB
HTBRG	VB
ALQLS	NNP
HWCEW	VB
IAMRW	VB
MINIBWS	NN
APILW	MOD
MCJBR	JJ
FRIRWTIWT	NN
HTRFMNW	VB
XWLIH	NN
TWWK	NN
NERWT	NN
GWRIWN	NNP
HQMT	NNT
FNATW	NN
HKNSNW	VB
HWCIAH	VB
WIFINSQI	NNP
BHSTMK	IN
EDINIM	JJ
FWKNWT	VB
BAMCEWT	IN
AWLPNIM	NN
LHTIIDD	VB
AWLPNIH	NN
KLKWTH	NNP
DWGMAWT	NN
HKFR	NN
MQUM	NN
AWKL	NN
XDIRT	NNT
MEJIM	JJ
yyCM	yyCM
XDIRH	JJ
SMIWN	NNP
FRBWB	NNT
811	CD
PITWXIM	NN
FWLXNM	NN
NXMD	JJ
APFRWTH	NN
ZBWBIM	NN
PZWRH	NN
HCHRWT	NN
SIWRW	NN
NXFPWT	VB
HCJMCM	VB
LHWRWT	VB
MWBHQT	JJ
RCBSQI	NNP
92.2	CD
IIEDH	VB
EFTH	VB
DWGLIM	NN
AWJWPIH	NN
MTQIIM	VB
AIPH	QW
LHTQIIM	VB
NIDWNW	VB
GLIMH	NN
ILDWT	NN
FXIQH	NN
HQFBH	NN
ERWKIM	VB
NIDWNH	VB
TGIE	VB
FRJWJ	NN
FWLL	NN
IFLBW	VB
FWLI	NNT
FWLJ	VB
EZWTH	NN
MIBXN	NN
HXZQT	NNT
MWPQDIM	VB
HXZQH	NN
AMCEIM	NN
SWBLIM	VB
MEWRIM	VB
TPAWRWT	NNT
ZIRWZ	NNT
DIWNIM	NN
FWLP	VB
DIWNIH	NN
MTWN	JJ
MTWK	IN
GWBRIN	NNP
XQIINIM	NN
SGRW	VB
JIPWSIT	JJ
PEWLT	NNT
RBNIH	NN
PEWLH	NN
MRWMH	JJ
SGRH	VB
RBNIM	NN
TWAM	VB
FWAPWT	VB
XFWPIM	JJ
JEWTW	NN
FIERN	NN
EDT	NNT
JWBI	NNT
JWBH	JJ
BRCLWNH	NNP
JWBE	VB
HNDSH	NN
MSWMN	VB
HNDST	NNT
O	NN
MNWXIM	JJ
PRWPWRCIWNLIT	JJ
JEWTI	NN
RWB	DT
EZBH	VB
MWCAI	NNT
RWE	NNT
MCWR	NN
MWNJRI	JJ
MN	IN
MI	QW
MH	QW
MEIZIM	VB
TIAJRLI	JJ
MT	VB
MCWA	NN
MS	NN
MR	NNP
RWX	NN
MWCAT	VB
RWZ	NNP
MCWI	VB
MPRSM	VB
RGIFWT	JJ
XWGI	NNT
KLWAIM	VB
XWDFIM	NN
HWBA	VB
IXPF	VB
ILDI	NNT
ILDH	NN
HRGFTM	NN
MJLIT	NNT
HRGFTI	VB
BWDDIM	JJ
PRQLIJ	NNT
JBRIH	NNP
ALWMINIWM	NN
SIWRIM	NN
QNDIIM	JJ
SIPRW	VB
HBQIEH	VB
GIFT	NNT
PRSWMIM	NN
AWSJRLIIM	JJ
NEWCH	VB
AWPNIIM	NN
IIMSR	VB
PRSWMIW	NN
FD	NN
BMHRH	RB
HFQENW	VB
IIALCW	VB
GIFH	NN
SIPRH	VB
MTBDXIM	VB
RIINWLDS	NNP
HWFEH	VB
LDLG	VB
WWDAI	NN
TWQNH	VB
MDWIQ	JJ
MTNHLIM	VB
FXR	NN
XIJH	NN
XTN	NNT
XTM	VB
LIMDW	VB
LIMDT	VB
IKXIF	VB
ASWR	VB
BWJWT	NNT
HCLXT	NNT
HZKRTI	VB
GWWEH	VB
ITPQD	VB
PUT	NNP
NIIDT	NNT
FRIJH	NN
ASWN	NN
IMQUA	NNP
BAW	VB
HNXH	NN
5,836	CD
BAR	NNT
SJND	NNP
BAQ	NNP
RNDI	NNP
IQWTIAL	NNP
SWKNWT	NNT
WEIDH	NN
HBRWT	NN
TWCAWT	NN
MTXIL	VB
ABJXH	NN
BAL	NNP
LQXIM	NN
BAH	JJ
BAI	NNT
APJUA	NNP
MXIRIM	NN
SIIEH	VB
LHZHIR	VB
GAWLH	NNP
TKWPWT	JJ
MQCT	NN
RWKLIM	NN
0891	CD
SIIEW	VB
XTIMT	NNT
XWFIM	NN
HWNXW	VB
XRKI	NNT
TBQF	VB
HPELTM	NN
JWBWT	JJ
ACBE	NN
ZETR	NN
LIQWIIM	NN
MTGLH	VB
FILMNW	VB
MSBIRIM	VB
RCINIT	JJ
STR	NN
TBQR	VB
WWED	NN
XWFIW	NN
HWGLH	VB
JWBWL	NNP
HPELTW	NN
AICMT	NNP
NCX	NNP
TWLDH	NN
LWKSMBWRG	NNP
TFE	CD
NCR	NNP
BINWNIT	JJ
PINTI	JJ
NCI	JJ
MWZMN	VB
TWRMIM	VB
RWZNSL	NNP
IGAL	NNP
NWQJT	VB
LID	IN
FNT	NNT
GRWEH	JJ
1691	CD
ARNWLD	NNP
EWLIM	NN
DLILH	JJ
MWSD	NN
PRSIM	NN
IFMF	VB
MRIBH	NN
ADWM	JJ
LIT	NN
TPISH	NN
ADWQ	RB
MSQRN	JJ
DLHI	NNP
FNA	VB
PWGE	VB
TRNGWLT	NN
BRAWNING	NNP
MPSIDWT	JJ
LHBJIX	VB
FNI	CDT
PWGM	VB
FLJWNW	NN
AIRGN	VB
XWLIIT	NNT
HMWN	DT
IWCRI	NN
MXWDDIM	JJ
TXTIT	NN
XWLQW	VB
PRWPSWR	NN
IIWWDEW	VB
MHSSIM	VB
PRDSNWT	NN
QBR	NN
QIBLH	VB
DIRT	NNT
TXZWR	VB
EIQRIIM	JJ
RIBAWNDIM	NN
LFWNW	NN
ZDWNIWT	NN
XICWNIWT	JJ
MPKUL	NN
QBE	VB
AWWIRIT	JJ
MSGRT	NN
RCIXWT	NN
MIQWX	NN
MFSH	VB
SIPWRH	NN
XFIM	VB
KAB	NN
IIFAR	VB
MQIPIM	VB
QANJIM	NN
DPNSIWWI	JJ
HGIBW	VB
ETIDH	NN
ETIDM	NN
KAN	RB
LSBWL	VB
XMQMQH	JJ
LHABQ	VB
ZWWEH	NN
ETIDW	NN
EFINW	VB
RHB	NNP
NTED	VB
PSIKWLWGIT	NN
IIFWMN	NN
MQWBLIM	JJ
TIGRH	NN
PRIWN	NN
TIGRM	VB
TRBWTIIM	JJ
DMWIWT	NN
ICIE	VB
RCIWNLISJIM	JJ
NZRQH	VB
FWMRIM	VB
MQWDFIM	JJ
XNH	NNP
DWQJRINH	NN
HFMCWT	NN
TBWANH	VB
MTWNH	JJ
AIRWPIT	JJ
PRWPWRCIWNALI	JJ
RPWBLIQAIT	JJ
GBRI	JJ
IINQJW	VB
HFG	NN
GBRH	VB
SALMINH	NNP
NWPIM	NN
RGWEIM	JJ
QPIDBIN	ZVL
RDIQLIIM	JJ
PWQWS	NN
QWSMJIQH	NN
NKPW	VB
16.11	CD
LPWRR	VB
ARBEH	CD
MIPGFIM	NN
ARBET	CDT
BGIN	IN
PIGWE	NN
ZITWNI	NNP
HWPEH	NN
ELWB	NN
NISWXIM	NN
AWTIWT	NNT
MIIFM	VB
IFWLMW	VB
KEWSH	JJ
MBJIX	VB
KIBWF	NN
PRIMIJIWWI	JJ
AWPJIT	JJ
GBRT	NN
NFENIM	VB
QWRT	NNT
KPWL	JJ
EMD	VB
HTABDWT	NN
ATM	PRP
TEBWRH	NN
QLIBR	NN
ATH	PRP
HIGIWN	NN
HMWNIIM	JJ
MERK	NN
ATR	NN
MERB	NN
AWSJRIH	NNP
KPWT	NNT
AWHB	VB
HFPETW	NN
QWRAT	NN
MEWRBWTW	NN
IXFWB	VB
7491	CD
NAPWLI	NNP
ADRIKLWT	NN
HWTIR	VB
MFWNH	JJ
2	CD
HWTRTM	NN
PWMBIT	JJ
NIQWL	NNP
KBIFIM	NN
LIIQRS	NNP
HWBIL	VB
TMWMF	VB
AIRANIIM	JJ
BGIDH	NN
HFGTH	NN
BKR	NNP
WAQWM	NN
EMI	NNT
HRTH	NNP
XMNIIH	NNP
LWWIITW	NN
NERI	NNT
NERH	NN
NERK	VB
MIQWMH	NN
IFIRH	JJ
FKLI	JJ
LLMWD	VB
MWLIKH	NN
KHIM	JJ
HIKL	NN
RWZN	NNP
HIKN	QW
MMFLTIIM	JJ
RWZI	NNP
RWZH	NNP
DGWL	JJ
ITMWK	VB
TARIKIM	NN
KFRWN	NN
MTPTX	VB
GWLDFMIDJ	NNP
NWQFWT	JJ
BIJLNW	VB
JWRNIR	NN
HIDRDR	VB
LCPWT	VB
CIIRIM	NN
IANQ	NNP
LXZWR	VB
WEDWTIW	NN
AWLIMPIIM	JJ
RIINHARDJ	NNP
PCWEIM	NN
MRBIT	DT
IHDWTW	NN
MWCHRT	VB
MRBIM	VB
GMWL	NN
IHDWTM	NN
TWKIX	VB
XNQW	VB
AWHLIM	NN
LHQRIN	VB
LZKWR	VB
EMWS	NNP
MMLKT	NNT
EMWQ	JJ
HTXNNW	VB
NWRWWGIT	JJ
LHQRIB	VB
MRGLIT	NNP
XWLLH	VB
ISKL	VB
EMWD	NNT
NWRWWGIH	NNP
HPSDIM	NN
TRBWT	NN
KFIRWT	NN
AGPIM	NN
RGBH	NNP
ECMTI	VB
IXIDIM	NN
IBIAW	VB
LHSTPX	VB
MIICGIM	VB
RIBIT	NN
MDENIM	NN
NQEH	VB
EDTI	JJ
QLIPT	NNT
IEDH	NN
MIWXDWT	JJ
ENQ	NN
MFWDRT	VB
ATMWL	RB
HTNGFWIWT	NN
BWQE	VB
SJH	VB
SIQSRS	NNP
RWQDIM	VB
JBEI	JJ
MEWRRWT	VB
FWRWTIHM	NN
JMWNH	VB
NICLW	VB
TFLWMIHM	NN
HXMIRH	VB
IRWQIM	NN
ARIALH	NNP
EBWTWT	NN
IFIBTH	NN
NICLH	VB
MRGIEH	JJ
MWSIPIM	VB
QWNSRBJWRIWN	NN
QILWP	NN
XJIPT	NNT
KIRWRGIM	NN
JWNIACI	NNP
HWRFE	VB
BLEDI	IN
HWFLMW	VB
XJIPH	NN
HWRFH	VB
MRKINH	VB
BHIR	JJ
MSTLQIM	VB
AMRIQAIIM	JJ
GWLDN	NNP
XIH	JJ
XII	NNT
JJRSJN	NNP
CBWRIIM	JJ
IDQWR	VB
MWLQWLWT	NN
XIQ	NNT
NWKXWTN	NN
HTRGFWT	NN
SWBARW	NNP
LHFBIT	VB
FMIIMIWT	JJ
ITMWDDW	VB
MBJL	VB
TTGIIS	VB
DWNIH	NNP
GWRL	NN
HPKH	AUX
GWRN	NNP
DNWN	NNP
QWJL	VB
PRSMH	VB
MGLMIM	VB
HWLID	VB
XMTW	NN
LIIFB	VB
MERKWNIHM	NN
GILITI	VB
SBIBWTIH	NN
IIXL	VB
PTRWNWTIHM	NN
EWBDWT	VB
ELIIH	NN
LWWNJINIM	JJ
NICNIM	NN
AIZWN	NN
LMXRT	RB
SDRI	NNT
KTBTW	NN
MAKZBIM	VB
SDRN	NN
SSGWNIT	JJ
SWERWT	JJ
BMSGRT	IN
NHGT	VB
NWTNWT	VB
GAWWH	NN
FIAM	NN
FIAN	NN
FIAH	NN
ZRWEWTIH	NN
SDRT	NNT
MTWKNNT	JJ
IPSIQ	VB
HISJWRIT	JJ
GWBRT	VB
MHLKIW	NN
MIKAL	NNP
IIEFH	VB
MTWQCB	JJ
ELIWN	JJ
HISJWRIH	NN
TMWRH	NN
IRIXW	NNP
IPSID	VB
ANWKI	JJ
BDIQT	NNT
RLWWNJI	JJ
AINW	RB
KWTB	VB
GNAQ	NNP
ALRGIT	JJ
MPEL	NN
GDL	VB
KWTL	NN
HLWWIIT	NNT
QWNWJCIWT	NN
IWECW	NN
AING	NNP
PSNTR	NN
MKTB	NN
HLWWIIH	NN
MQWWIM	VB
AINM	RB
AINN	RB
AINH	RB
AINI	RB
AINK	RB
LWZ	NNP
HCDQH	NN
XWPFWT	NNT
QWRS	NNT
MGRWT	VB
FWJR	NN
FWJP	JJ
IFTLW	VB
NWJS	NNP
AMWR	VB
IDIDI	NN
IDIDH	NN
AMWT	NNT
PRW	MOD
ALPIM	CD
FNAH	NN
LCLWE	VB
AWRXIM	NN
LWS	NNP
MTIM	NN
IDIDW	NN
NWJH	VB
AMWN	NN
NWJL	VB
TQCH	VB
AMRNW	VB
MNWSH	JJ
TNWETW	NN
LHMCIA	VB
QWRH	VB
TKLITH	NN
FAIPH	NN
TINTN	VB
LZQWP	VB
ZWMN	VB
JWRQIWT	JJ
PWTXIM	VB
ALIM	JJ
FBIRH	NN
BICWEW	NN
NFWT	NNT
DANPRMLIN	NNP
RUG	NNP
ABNEL	NNP
DWALIWT	NN
NFWI	NN
KBIFI	NNT
IZQWP	VB
LHFTKNE	VB
BICWEI	NNT
HTIICBW	VB
BICWEN	NN
LFMWE	VB
DIH	MOD
DII	NNP
TKLIT	NN
INSH	VB
MFTNH	VB
FWTQH	VB
RPAL	NNP
EBRWN	NNP
LEQWR	VB
AWNIM	NN
LEQWP	VB
INSW	VB
NSIWN	NN
DHIRH	NN
FIJTIIM	JJ
IQBL	VB
DIQ	NNP
DIR	NNP
DIS	NNP
BIQWRW	NN
XFPTI	VB
BIQWRT	NN
TXILH	RB
PXWTH	JJ
LHTKNS	VB
MSIQ	VB
RWWIW	NNP
LWD	NNP
MSIM	NN
AIRWPIIM	JJ
AIQH	NNP
REIWNI	JJ
HTEKB	VB
HWFGW	VB
PRFNIM	NN
TWXLT	NN
AIDIAWLWGI	JJ
GWMEH	NNP
I	NNP
IRQ	VB
LIRJWT	NN
HKFIR	VB
IIFWTI	NN
IRW	VB
IRH	VB
IRI	NN
HKFIL	VB
HQBLH	NN
IRD	VB
HWFGH	VB
MRKZIIM	JJ
QPSPBINKN	ZVL
PWR	NNP
PWS	NNP
FSWEH	JJ
MRKZIIH	NN
60,000	CD
HBXNH	NN
ARHUB	NNP
APSIM	NN
ETIDNW	NN
APSIQ	VB
APSIT	JJ
PEMIM	NN
QANIBLIM	JJ
PWL	NNP
MRKZIIT	NNT
HTPWRRWT	NN
LDQLM	VB
BNWTIHM	NN
BNWTIHN	NN
XLILH	RB
HWDIIM	JJ
HFRAH	NN
HCLIX	VB
NAH	JJ
DRIIB	NNP
LHBXIN	VB
ITSWS	VB
001,000	CD
TRBH	VB
NAW	MOD
MQWMIIM	JJ
SWLTM	NNP
LNTQ	VB
BDIDWTW	NN
FALNW	VB
PJRIQ	NNP
RBWEIM	JJ
AILWC	NN
AWNIBRSIJT	NNT
ELBWN	NN
PRFN	NN
HARH	NN
PRFH	NN
MFJRIM	NN
PRFT	NNT
ALQJRWNIQH	NN
CEIRH	JJ
MTKWNNIM	VB
HCJIINW	VB
AWNIBRSIJH	NN
LHELWT	VB
IWGWSLWWIT	JJ
GIDWLM	NN
TBWA	VB
NEIM	NNP
HRBW	VB
LHIXRC	VB
JIFJF	VB
MGMH	NN
LBBIIM	JJ
FQWEH	VB
JEWNWT	VB
FIERTI	VB
XRIG	NN
XRIF	NNP
HRBH	DT
AMRH	VB
IWGWSLWWIH	NNP
WIJLI	NNP
PIJWRI	NNT
2551	CD
TWCAWTIW	NN
NDWFIM	JJ
MWJLIM	NN
PEM	RB
MWZKR	VB
CIWNIT	JJ
MTPLLT	VB
CIWNIM	JJ
APWSJRWP	NNP
JISIIH	NNP
MTXILIM	VB
IIMCAW	VB
TWCAWTIH	NN
TDIRAN	NNP
LPID	NNP
LKN	CC
FLX	VB
AZRXIT	JJ
BQRB	IN
ARNWNH	NN
MWUM	NN
MWUL	NN
LLKT	VB
CNCNWT	NN
MTQDMIM	JJ
XLFIM	NN
HBITH	RB
LHTRXQ	VB
GBWHIM	JJ
FLJ	NNT
FLM	JJ
FLL	VB
MIICGT	VB
FLA	RB
WWEDH	NN
FLB	NN
TIABQ	VB
FLD	NN
LEQL	VB
BWBH	NN
AIRAN	NNP
XWLWN	NNP
LRQWD	VB
TWCRT	NN
PGIEWT	NN
MCLMWTIHM	NN
PRNCSQW	NNP
MWNEIM	VB
NWSPWT	JJ
MWSIPH	VB
HFTDLNW	VB
HIEDRWT	NN
RFLNIT	JJ
TBIEWT	NN
EWIN	JJ
MFTRE	VB
QLJNW	VB
XICWNIIM	JJ
AWPCIWT	NN
MFQI	NNT
MFQL	NNT
HTQPH	NN
RIALIZM	NN
GWLM	NN
HNDSAIM	NN
QIBLTI	VB
MBWSST	VB
MXW	VB
MSTBR	VB
XZWTW	NN
MCPWT	VB
LRFWM	VB
HTQPT	NNT
MRFM	NN
KPRIHM	NN
BIINIF	NNP
TRBWTIWT	JJ
ISMNW	VB
TWELT	NN
MPWXDIM	JJ
SAWNH	NN
CWMT	NNT
PWELT	VB
CWMX	NN
CWIIN	VB
MGWWN	NN
NWDET	JJ
LXIMH	NN
AMQWR	NNP
HWRH	VB
PASIWWIWT	NN
NA	RB
NIHL	VB
LFQM	VB
NE	VB
IHLWMI	NNT
LFQP	VB
HWFKRW	VB
FIEWRI	NNT
NQ	NN
NR	NNT
NS	NN
IWRKB	VB
NW	RB
HQPDTW	NN
FMXH	NN
KIWM	RB
CNRT	NN
MQCWEWT	NN
MNWRH	NNP
HTARGNWIWT	NN
TBWNT	NNT
ABWQSIS	NNP
SXIJT	NNT
LTMWK	VB
CLSIWS	NNP
NIRIT	NNP
ZWRMIM	JJ
KIWR	NN
RIHWJ	NN
FMXT	NNT
LHPGIN	VB
IFRAL	NNP
LHPGIF	VB
IPAN	NNP
NBNH	VB
ELIWNH	JJ
TWRGM	VB
31.5	CD
JLPWNIM	NN
MQIPH	JJ
ICJRP	VB
501	CD
MBINIM	VB
LASWR	VB
TMLA	VB
XDFIMIFNIM	JJ
LMKWR	VB
CPWNH	NN
AZL	VB
SKSWK	NN
SIDRH	NN
MIMWFN	NN
MLMIN	NN
AINJIMIIM	JJ
MIMWFH	NN
MWLH	NN
KWWIT	NNP
AIMTNI	JJ
EZR	VB
AXRT	JJ
MHPK	NN
NXWC	VB
AZWRIM	NN
DACH	NNP
QIBWCI	JJ
MNPRDI	NNP
PINWI	NNT
HTAM	NN
HTEWRRW	VB
MFXQI	NNT
ICJRK	VB
ARTWR	NNP
MFXQW	NN
GIBWI	NN
IWCR	NN
MIICRT	VB
T.D.	NNP
ALJR	NNP
MSMRIM	NN
HRAWBNI	NNP
QLINGR	NNP
IKRIEW	VB
AQDX	NN
MSWIMWT	JJ
MFTDLIM	VB
MENIF	VB
TIEFH	VB
FKBH	NN
MWPIE	VB
NQBEIM	VB
KNWT	NN
RWXW	NN
RWXQ	NNT
NDKAIM	NN
IWAL	NNP
CWPRI	NNT
IWAB	NNP
TIRFM	VB
CATM	NN
CATN	NN
MWEDP	JJ
BIGWN	NNP
MFTQWT	VB
HQPDTI	VB
RWXC	VB
RWXB	NNT
NCIGIHM	NN
TWKN	NNT
BIGWD	NN
TDMWR	NNP
FIBWCIM	NN
RWXH	NN
HIIT	AUX
XNWK	NNP
HGDLT	NNT
XNWN	NNP
DWNALD	NNP
BRIAH	JJ
MFMIEIM	VB
AIRDINGN	NNP
MBJA	NN
MMFIKIM	VB
FBWEIT	JJ
XNWQ	JJ
PINIQS	NNP
HPCIR	VB
LHTMQD	VB
IZWZ	VB
SIKN	VB
EBDH	VB
BKIR	JJ
GBRIM	NN
NRXBWT	JJ
CIRWP	NN
NRTMT	VB
PSXH	VB
MSLWL	NN
NAPH	VB
1,053	CD
FMALN	NN
FMALI	JJ
LJEWT	VB
TAWNH	NN
CRKNI	NNT
1,500	CD
XLMWNIT	NN
RMZIM	NN
RAFWNH	JJ
RAFWNI	JJ
WSJLND	NNP
FQWP	JJ
MEIQH	VB
TAWNT	NNT
JRM	RB
LMLA	VB
RAIWT	NN
SEWD	NNP
NWGET	VB
LKAWRH	RB
EWMDT	VB
RAIWN	NN
ESQ	NN
TPQDM	NN
JRAWMWT	NN
XWBRT	NN
HRIWN	NN
WIDIAW	NN
IXID	JJ
QLEIM	NN
LHPIL	VB
NWFIM	NN
IEBWR	VB
NFALIM	NN
QRJR	NNP
GWPW	NN
IXZIQW	VB
XWJB	NNT
GWPR	NNP
FKNWTIH	NN
MLKWD	NN
96.4	CD
AIKPT	VB
APWDIM	NN
NIWZ	NNP
BWGRI	JJT
MHNDS	NNT
MFJXIM	NN
ITEFR	VB
MCWMCM	JJ
HTAQLMW	VB
QWLWNIWT	NN
FKIXIM	JJ
IEILIM	JJ
RIFWM	NN
IPCICW	VB
MSBIB	RB
ASPNIM	NN
DLH	JJ
LHPQID	VB
QWDMIM	JJ
HIRRKIH	NN
PWRWMIM	NNP
QWDMIW	NN
AIRWPI	JJ
AIRWPH	NNP
MTWKNN	VB
GIRSAWT	NN
XWJP	VB
SPWRIM	JJ
DLQ	NN
QWDM	RB
MILICIH	NN
LGRF	VB
MERIKIM	VB
XIWBI	JJ
MCWIINT	JJ
QWDF	NN
PNIHM	NN
MGRFW	NN
NKTBIM	VB
XWBTH	NN
LESWQ	VB
DLT	NN
PWRMIIQH	NN
HNCW	VB
KWLLT	VB
IMCAW	VB
MCWMCMIM	JJ
FWLIWT	JJ
BRIIJWN	NNP
BIGZ	NNP
AWGW	NNP
IIXFB	VB
LHDIX	VB
LWJW	NN
NZKWR	VB
FMRNIT	JJ
THLWKH	NN
LWJH	NNP
TIPGM	VB
6	CD
NPLAH	JJ
RPWBLIQH	NN
AWJWNWMIH	NN
BRWDI	NNP
GWPIM	NN
ESWQH	JJ
MWGZMIM	JJ
TPEL	VB
MNWCLIM	VB
XQLAIT	JJ
MFKWRWT	NN
XQLAIM	NN
TZMWRT	NNT
QLGSIW	NN
WILBWFBIC	NNP
MKH	VB
AWMNM	RB
MPGF	NN
AILW	CC
AILT	NNP
MPGE	NN
LXCH	NN
SGNIHM	NN
TSBWKT	NNT
MPGR	JJ
AILC	VB
LFLWJ	VB
LHFWWT	VB
BARAN	NNP
MKS	NN
MWPLGT	JJ
AILN	NNP
MSIIM	VB
NKLLIM	VB
FQJ	NN
RENN	NNP
FQI	NNT
AIK	QW
FQL	NN
RDAI	NNP
NTINI	NNT
MGALWMANI	JJ
MWNJIPIWRI	NNP
FQE	VB
MILWLIT	JJ
IRBW	VB
FWHH	VB
QWALICIWNI	JJ
MLWJF	JJ
FWHM	NNP
AWLDHAM	NNP
MTKT	NN
PNSW	NNP
RICARD	NNP
EIRAQIT	JJ
MTPREIM	NN
NWHL	VB
EIRAQIM	NN
BRBF	NNP
NWHG	VB
MNCXIM	NN
SRWG	JJ
XNIKH	NN
QICWC	NN
APGNISJAN	NNP
RWPAIM	NN
MTPRCIM	VB
SIPWRI	NNT
MTAIM	JJ
XRDIM	NN
LWBIC	NNP
LEJWP	VB
ZRE	NN
MZIQIM	NN
SIPWRW	NN
LEJWT	VB
ZRA	NN
ZRM	NN
LNHWG	VB
ITPRSMW	VB
XIIW	NN
MWCET	JJ
QDMW	VB
WILH	NNP
LMFWK	VB
DFA	NN
HCDH	RB
QDMH	VB
JWRDNI	JJ
PLIJ	NN
PLII	NNP
HBANW	VB
GLWBWS	NN
PFR	NNT
AQDWXW	NN
IFKWN	VB
LFEBR	MOD
NTEQF	VB
FALWTIH	NN
NFMEH	VB
QPTMWNH1	ZVL
NSPX	NN
NIKRIM	JJ
XWCH	NN
LHIPJR	VB
SWMK	NNP
HTBJAH	VB
ADIRWT	JJ
LKNS	VB
SWMN	VB
CIWNWT	NN
HPSDH	NN
MMFLWT	NNT
MTLWWIM	VB
AWPUA	NNP
PWLIJIQAI	NN
QPSPBIN	ZVL
PRINCIP	NN
SBLNWTW	NN
XCWT	NN
LGMRI	MOD
BRKWT	NN
MITMMIM	JJ
HPSDW	NN
BIJWII	NNT
EIQRW	NN
XFMLIIM	JJ
I.	NNP
HMWCET	JJ
EIQRH	NN
EIQRI	JJ
MNWSBIC	NNP
PNWIIM	JJ
ATLJIM	NN
IPH	JJ
XINH	NN
XINM	NN
MXIIBIM	VB
NDIBIM	JJ
FFH	CD
IPW	NNP
MZLM	NN
GWPRIT	NN
TLAWT	NN
ANJMN	NNP
NGD	IN
NGE	VB
AWRWWLIANIT	JJ
TILXM	VB
HDS	NN
HDR	NNP
NGB	NN
HDP	VB
KSPRIT	NN
MAMIN	VB
NGH	NNP
CIIR	NN
LHWFIJ	VB
CIIN	VB
IIFWBIM	NN
MQWMIT	JJ
NGX	VB
HENQT	NNT
KHNIZM	NN
20.1	CD
AZRXIM	NN
16.30	CD
SMWAL	NNP
LHQIM	VB
PRDI	NNP
AWPRJIWWI	JJ
ATIAIZM	NN
LHQH	NN
PIINBRG	NNP
BMW	IN
AWJWBIWGRAPI	JJ
NWHLI	NNT
HMWNIM	NN
GIBF	VB
NIQL	NNP
SHR	NN
GIBE	NNP
PSIKWMJRIWT	JJ
XRGW	VB
RCWP	JJT
AICIQ	NNP
MSKN	VB
HWAILW	VB
HWPEWT	NNT
RCWN	NN
EBWDWT	NN
MSKT	NNT
LHIXLC	VB
GZBR	NN
CBIEH	NN
ECB	NN
MWJLWT	VB
MGE	NN
ANDRII	NNP
RQJWR	NN
MGI	NNP
MPZR	VB
RWCH	VB
JRIJWRIH	NN
MCWQT	NNT
XIIL	NN
TFLWMIM	NN
ARCM	NN
ASJRJGI	JJ
XWLQIM	VB
LAMBR	NNP
RWCX	VB
ECM	NNT
HISJWRIWGRPIH	NN
LQCR	VB
RFIMTW	NN
MWWT	NN
HMFIKH	VB
IFIR	JJ
NFARIM	VB
LQCC	VB
ECI	NNT
HMFIKW	VB
IFIF	JJ
GRINFJIIN	NNP
LLMD	VB
HENIQ	VB
MTMXH	VB
HWXDRH	VB
HTPWRRWTH	NN
PWCC	VB
PGFNW	VB
NFAW	VB
HEWWIH	NN
IQIIM	VB
FMWTIHM	NN
PWCH	VB
IIRGEW	VB
LPTWX	VB
HTNQFWT	NN
HWRIHN	NN
XWCWT	NN
LMDTI	VB
TEMWLTH	NN
LPTWR	VB
HTXLTI	VB
LHKWT	VB
HWQET	NNT
AWPIINH	VB
29.90	CD
MPRSMIM	VB
MRQXT	NN
QFT	NN
PIRWFH	NN
CNWEIM	JJ
MTIIXST	VB
MEILH	NN
MAZNM	NN
AXWZIM	NN
FNIIM	CD
QFH	VB
QFI	NNT
NMFK	VB
FNIIH	JJ
GINII	NNP
AFUP	NNP
MIQI	NNP
TCIE	VB
ICPW	VB
TCIG	VB
IWFBIH	NN
HTQNT	NNT
HQIMW	VB
IWFBIM	VB
HSBH	VB
TPQIDH	NN
MQLEIM	NN
TQRIT	NN
IMHRW	VB
HCLXNW	VB
MQWMI	JJ
KET	RB
HQIMH	VB
XFML	NN
MQWMM	NN
HSBR	NN
LNQWJ	VB
SILWN	NN
NHRGW	VB
NTQ	NN
MRDP	NN
LNQWM	NNP
MFWBCWT	JJ
HIDRDRNW	VB
SWGRIM	VB
WWIIS	NNP
PRIST	NNT
ABIW	NN
RBDIM	NNP
ABIH	NN
WWIIJ	NNP
ABIN	VB
WWIIN	NNP
ABIB	NN
75.90	CD
HWEMD	VB
HCJRPH	VB
TPJWR	VB
GPN	NN
TQPID	VB
GWRBCWB	NNP
PEWLTW	NN
RAFWT	NNT
KHNISJIWT	JJ
HWLIDIIS	NNP
DWX	VB
RAFWN	JJ
PEWLTM	NN
PEWLTH	NN
MIWCRIM	VB
DRGT	NNT
ICAW	VB
1.2.19	CD
NMRCIM	JJ
MKWPLT	JJ
M	IN
HRNJALS	NNP
MXMMIM	VB
LHTBJA	VB
DWQJWRJ	NN
ICAH	VB
MDBRWT	VB
MFWEMM	JJ
HEID	VB
DRGH	NN
LHTPRNS	VB
IDWE	VB
PWRNWGRPIIM	JJ
MTAKSNIM	VB
NKTB	VB
KNIST	NNT
NTRAH	VB
NWTRH	VB
RMPH	NN
01.00	CD
PISIWLWGI	JJ
MXLIPIM	VB
MAMINIM	VB
LASQW	NNP
MGIEWT	VB
AXR	JJ
MIJB	NNT
NIQWLSWN	NNP
QWLNI	JJ
AXZ	VB
IECBW	VB
XMMH	NN
QPKWT	ZVL
QARLSRH	NNP
NIXWX	NN
AINJNSIWWIT	JJ
AXD	CD
MWAFM	VB
AIFIWT	NN
IUF	ZVL
MWNFM	VB
HCJRPW	VB
MRCIM	VB
TMNE	VB
LHTERB	VB
WWDAWT	NN
AWRWT	NN
MQBL	VB
ITBCE	VB
MQWMWN	NN
QWRET	VB
AXRITW	NN
HDGFH	NN
MQWMWT	NN
NECBNW	VB
JIPWLIM	NN
BIWTR	MOD
LHTQFR	VB
CBWEIM	VB
HSTBR	VB
HMGDLIT	NNP
XBIB	JJ
IFWXRRW	VB
NQNSH	VB
IWRIM	VB
NSWGW	VB
LTSWS	VB
AHRN	NNP
FMWAL	NNP
XBIT	NN
EISWQW	NN
FLIFIT	JJ
NIKWI	NNT
GRZI	NNP
1400	CD
BKDI	RB
GRZN	NN
WIILD	NNP
QNCLR	NN
MZX	NN
LHFMIC	VB
IWCA	VB
MWEDWNIM	NN
MZG	NNT
MAWKLSIM	VB
MZL	NN
BDLNIT	JJ
TRWEH	NN
MGZRIM	NN
LNHL	VB
7.30	CD
NPGET	VB
MCIAWT	NN
311	CD
KPRIT	JJ
GJAWT	NN
PRQLIJWT	NNT
KPRIM	NN
PIDIWN	NN
ZIQTW	NN
GWRBIC	NNP
NWSH	VB
AMNI	NNT
NWSK	VB
BNWIIM	JJ
AMNM	RB
QWDFBIC	NNP
QRISJI	NNP
AWRWN	NNP
RKIST	NNT
NWSE	VB
ALPRD	NNP
NWSX	NNT
FWER	NN
RGFI	NNT
HTQBL	VB
HCIE	VB
NWSP	JJ
NRQXIM	VB
AMNT	NNT
KNST	NN
AMNW	NN
LHEDIP	VB
HCIG	VB
XLWP	NNT
FQIM	NN
MRWWAN	NNP
XMIFIT	JJ
PWJR	VB
FQIT	NN
XMIFIM	CD
XLWC	NN
XLWM	NN
WILI	NNP
XLWN	NNT
MIFXQI	NNT
AISMEIL	NNP
HRKBW	NN
CHBHB	JJ
EISWQ	NN
JRIJWRIALIT	JJ
BWSIM	NN
CBAWT	NNT
IBBWT	NN
HRKBH	NN
HRKBI	NNP
LHILXM	VB
TMKH	VB
HNHIG	VB
NWKXI	JJ
MJBEWT	NN
MPGINIM	NN
AGUX	NNT
GIRWF	NNT
HCIT	VB
MSCWSJS	NNP
NWKXT	NN
HTHWWH	VB
NBWNH	JJ
HWLMT	JJ
BSWP	RB
LAFR	VB
TIJWL	VB
BWLJ	JJ
HISJWRIWT	JJ
CILCL	VB
GRIST	NNT
MIMWF	NNT
WWLWNJARI	JJ
CRKNIT	NN
XMF	CD
FERIIM	NNP
MIMWN	NN
MQRJE	VB
CRKNIM	NN
ECWMWT	NN
MWDPSIM	VB
GRISH	NN
MFQAWT	NN
XMW	NNP
XMQ	VB
FIKTBTI	VB
XMWFIM	JJ
CHRIM	NN
SIBT	NNT
MCBIEIM	VB
PICWXIM	NN
MWCA	NN
MZWN	NN
MFMEWTN	NN
ELWLWT	VB
BWNDSLIGH	NNP
ATLJIQH	NN
QWFI	NN
PWRMLIWT	JJ
FLIXIM	NN
MAWWRIQS	NNP
SPWJNIQ	NNP
MWCB	VB
ESQIW	NN
MMFLTIWT	JJ
ESQIT	JJ
MPRIE	NN
HNAH	NN
HNDSIWT	JJ
MPRIK	VB
PNJZIH	NN
WWDAIT	JJ
XFWBIM	JJ
AWPNH	NN
NFA	VB
EWSQWT	VB
ESQIM	NN
BWLEWT	VB
ABIBIT	JJ
HTNDND	VB
RNWAR	NNP
AIWWAN	NNP
MEJWT	JJ
MXWDFT	JJ
IWMM	NN
LJWBT	IN
BNIINI	NNT
FIEI	JJ
BXFAI	RB
GASQWIN	NNP
EMITW	NN
LWLA	IN
NERMH	VB
HTLWWH	VB
MWSMKT	VB
ELWBIM	JJ
XIWBIT	JJ
JIEWN	NN
5203	CD
HTBGRWTW	NN
AWMLL	JJ
MPGIF	VB
CIMCM	VB
MILIWN	CD
IRIDH	NN
MXD	RB
BIIM	VB
TZKWRT	NN
LXMM	VB
SBLW	VB
PEILWT	NN
LXMI	NN
ZIKRWNI	NN
MSTPQIM	VB
IQIIMW	VB
MMCA	NN
QNQN	NNT
ZIKRWNW	NN
QWBEWT	VB
KWXW	NN
FWM	DT
FWN	NNP
AGTH	NNP
MRWFFT	JJ
DISLDWRP	NNP
FWD	NN
XDF	JJ
KSPWMJ	NN
BAFRI	NNP
FWB	RB
EITWNIM	NN
BLIT	IN
PRANQPWRJ	NNP
FWT	NN
IFTKNE	VB
FWQ	NN
FWR	NNP
LHTAWFF	VB
JIPWLIWT	JJ
MXIAWT	NNT
MGILT	NNT
MSEIRIM	JJ
MHNDSIM	NN
HKXDH	NN
MSWKN	JJ
PWJNCIALIIM	JJ
HTPFJH	VB
FPREM	NNP
FPRINCQ	NNP
DIIQ	VB
IXNKW	VB
MIJH	NNP
SWCIALISJIT	JJ
XWSM	VB
RISWN	NNT
DIZNGWP	NNP
LPRWK	VB
DIIN	NNP
DIIL	NNP
HFQPWTIW	NN
HTPFJW	VB
IXDF	VB
HTASP	VB
GWRE	VB
MSQR	VB
BWFWWIC	NNP
MWCGT	VB
MTWRBTT	JJ
RQE	NN
DRWFIM	JJ
FXUL	NNP
SWCIALISJIM	NN
RQM	VB
KPWI	VB
ITNHGW	VB
FARIWT	NN
JDI	NNP
NIGWSIM	NN
MWPE	NN
LHRHR	VB
MGLMT	VB
MMWQMT	VB
DET	NNT
CRPTIIM	JJ
PRNSISQW	NNP
NRDP	VB
MFIB	VB
NICWCWT	NN
HCMID	VB
QCINIM	NN
MWTIRH	VB
KR	NNT
BQFTN	NN
GEGWEIM	NN
FKM	NNP
IIKLLW	VB
3,247	CD
HBJXT	VB
MXPFWT	VB
GIBALIH	NNP
HBJXH	NN
MMWQM	VB
AWLJIMJWM	NN
MWZIAWNIM	NN
XLWCI	NNT
FPIWT	NN
MRWCT	NNT
GBAI	NNP
ADIPWS	NNP
HWLIWWD	NNP
MILIJNJIWT	NN
DIILT	NN
NWSIIBH	NNP
CMWD	JJ
MDI	MOD
MWDRKIM	JJ
PNQS	NNP
QCWWT	NN
HIQF	NN
NDIR	JJ
FKX	VB
SMRJWJ	NN
WWLB	NNP
KWFRM	NN
ZWKIM	NN
SIDWRI	JJ
AQSIWMH	NN
HSKMNW	VB
NICBWT	VB
FWRF	NNT
NIHLH	VB
SIRBH	VB
NEL	NN
HENWT	NN
PSIKWLWGIH	NN
DWXH	VB
27.40	CD
QRBWT	NN
ACL	IN
MTRPSIM	VB
LHKFIL	VB
FWTPIM	NN
9.90	CD
yyELPS	yyELPS
MHIR	JJ
MNSIM	VB
NER	NN
GRMNIM	NN
SIRBW	VB
NIHLW	VB
NHDR	JJ
MFQWLAIM	NN
AFMIM	NN
HNIXH	VB
MBDRT	JJ
MJLWN	NNP
MSPRM	NN
PIRWFW	NN
BKI	NN
GDWLIM	JJ
NIQWI	NNT
MSPRT	VB
SJ.	NNP
TFWBH	NN
PRBR	NN
NIQWD	NN
ZIWWH	NNP
GILM	NN
MSEM	NN
GILH	VB
MSEH	NN
SJR	VB
LWWRQWZN	NNP
RCINWT	NNT
TWPEWT	NN
MIFWR	NN
PATWS	NN
DAGLS	NNP
XILWPIM	NN
ECIM	NN
MIIXLIM	VB
RXCH	NN
MSEW	NN
GILW	VB
MFQLW	NN
MWJWWSL	NNP
MED	VB
GDR	NN
HIFWWTH	VB
HWGFH	VB
MEL	IN
RWAH	VB
RWAI	NNT
MBWJLT	JJ
NHGI	NNT
MEJ	DT
NHGW	VB
PLIATW	NN
MXZWRIM	NN
GDH	NN
GDI	NNP
HWGFW	VB
NXRCWT	RB
LJWS	VB
LWX	NNT
PRWGRMT	NNT
XWLCTM	NN
ANGLI	JJ
ANGLH	NNP
QRWWANIM	NN
NXWCH	VB
HCJBRW	VB
HTBRRH	VB
ANGLS	NNP
LWI	NNP
RGLIIM	NN
LWL	NN
PRGWN	NN
ZMN	NN
EQILWB	NNP
APFRIT	JJ
IKIN	VB
LNSX	VB
KWHN	NNT
FALWTIHM	NN
MLWWIM	NN
HCJRPWT	NN
CEDI	NNT
MCWIINIM	JJ
CEDT	NNT
CEDW	NN
GLIWLIN	NNP
IKIR	VB
KP	NN
XLLI	NNT
EWMD	VB
EWMS	NN
EWMR	NN
EWMQ	NNT
MQRQEIM	NN
MIWN	NN
DXIPH	NN
MQIIM	VB
NWHGI	NNT
ZAJWJIM	NN
IWNIWWRSL	NNP
MTRXF	NN
QDM	MOD
DRWFH	VB
NTBQF	VB
EZH	NNP
HCIEW	VB
GREINIM	NN
HSDR	NN
EZB	VB
NWHGT	VB
CPH	VB
CPI	NN
GNRLI	NNP
DTIIM	JJ
PRCWP	NN
XWMRIM	NN
MEWDDT	JJ
XQIRWT	NN
AWJWBWSIM	NN
JWQIW	NNP
IDETI	VB
MRBI	JJ
MRBH	DT
CPT	NNP
SILQW	VB
CPW	VB
ALWHIT	JJ
XWLWNI	NN
FMRNIM	NN
CIMRIM	NN
PENWX	NN
LXIIM	NN
XMWRIM	JJ
LXIIG	VB
ALWHIM	NNP
JEM	NN
MFLBT	VB
LXIIB	VB
MGWFMT	JJ
FWAPT	VB
BAIIRN	NNP
SMKWTW	NN
NRCXIM	NN
KIKR	NNT
XWCPNIT	JJ
ARBE	CD
HTPTXH	VB
LIWWI	NN
XTWNH	NN
MDBRIM	VB
SIWMH	NN
NKBFH	VB
IPEL	VB
63.5	CD
HTPTXW	VB
EICWMN	NN
EICWMH	NN
IFRALIWT	JJ
IISD	VB
MICWI	NN
EICWMW	NN
NBIAIM	NN
FWPKIN	NN
NKBFW	VB
HGENW	VB
FAWL	NNP
LSGWR	VB
AINPLCIWNI	JJ
HARWWI	NNP
ZNIAL	NNP
NABQIM	VB
LHZMIN	VB
LHTGWNN	VB
QRQEWT	NN
RFIWN	NNT
IGBRW	VB
LCXWQ	VB
HIFG	NN
HLWWAH	NN
ANFI	NNT
LPEWL	VB
NWFAIM	NN
PTRWN	NN
MXNWT	NNT
IHPWK	AUX
LHTQDM	VB
SPRJIZM	NN
HISJWRIWN	NN
RMALLH	NNP
FMLWTIHN	NN
RGFIIM	JJ
SBA	NN
MWJW	NN
KWWNT	NNT
NCPH	VB
ZKWIWTIHM	NN
FJXIM	NN
HTQDMWT	NN
AWMWT	NNT
AXWWT	NNT
TWTQP	VB
MFMEWTI	JJ
JRGDIH	NN
HDDIWT	JJ
TXWMIW	NN
GBWLIT	JJ
IWMW	NN
MBQRT	NNT
MRDKI	NNP
MXR	RB
XWWIWTIW	NN
FINIW	NN
LXKWT	VB
TQNWNI	JJ
PNSIWNR	NN
BRIJI	JJ
MBQRI	NNT
IWMI	JJ
SIBH	NN
TXWMIM	NN
LEWRR	VB
LIPFIC	NNP
XWDRWT	VB
RAISH	NNP
HXLPTW	NN
MABQM	NN
MZLGWT	NN
HRISH	NN
FIXQ	VB
LIICG	VB
ZKWTH	NN
RWAIIN	VB
SIKLH	VB
XWZIM	NN
MATRWWL	NNP
NFIA	NN
TWLDWT	NNT
HPTIE	VB
TFPR	VB
AWM	NNP
HTLHBWT	NN
AWFWWIC	NNP
NWQB	JJ
WWLQN	NNP
MXIITN	NN
MEBIR	VB
QIIJNWT	NN
NWQJ	VB
QWNWWNCIWNLIT	JJ
LRCWX	VB
XLQW	NN
XLQT	NNT
EMLWT	NN
ECMNW	PRP
AWWIR	NN
SWBLNWT	NN
RJNR	NNP
MDAIGIM	VB
FWHWT	VB
ZMR	NNT
XLQI	NNT
XLQH	NN
MIWXDIM	JJ
XLQN	NN
XLQM	NN
EWNF	NN
MIWXL	JJ
MDRIK	NNT
TEFIITIT	JJ
LIIQS	NNP
MIWXD	JJ
IKWLIM	VB
ARMLI	NNP
TTXIL	VB
EWZBIM	VB
NSIGH	NN
AWQJBIW	NNP
MIWXS	NNP
IXWIB	VB
MDIPIM	VB
MIMIQH	NN
ASPQT	NNT
HQCAH	NN
HNHGH	NN
TMIM	JJ
IWQRTW	NN
LBWTNW	NN
GAWN	NNT
HTPRCWIWT	NNT
TMID	RB
BHDGFH	RB
BJIXWTI	JJ
SRGIW	NNP
HWMNIJRIT	JJ
IWQRTI	JJ
IQLW	VB
HRSNIT	JJ
HNHGT	NNT
AWBSSIH	NN
ASPQH	NN
NBDQH	VB
MNWTQ	VB
DQR	VB
ZAWWIH	NNP
KMWT	NNT
HCHIRW	VB
NAMRH	VB
NAMRW	VB
HCHIRH	VB
IWBIL	VB
MXDLI	NNT
MEMQI	NNT
NBDQW	VB
NBDQT	VB
DIRQJWRIWN	NN
LHBQIE	VB
QISINGR	NNP
LHCIT	VB
BZRNW	NNP
RIGWBRJW	NNP
HWRFEW	VB
BRNADJ	NNP
Q	NNP
LHCIC	VB
LHCIB	VB
MRWXQ	JJ
TNWR	NNT
LHCIG	VB
MFQPIM	VB
ARGEH	NN
LHCIL	VB
3,825	CD
BWJLW	VB
HTAWFFH	VB
DIRDR	VB
EWNFI	NNT
RAFWNWT	JJ
DXTH	VB
SML	NN
MDEIT	JJ
TFWAWT	NN
BWJLH	VB
LSBK	VB
QLIFAWT	NN
CWLMW	VB
LIIXS	VB
PRQLIJW	NN
PRQLIJT	NNT
PSJIBL	NNT
ARJILRI	JJ
ICLMW	VB
ALPIIM	CD
HWBQE	VB
ID	NN
SWTBIS	NNP
X	NN
MDBR	VB
PRQLIJI	NNT
PRQLIJH	NN
MKRZ	NN
KT	NN
IFIBH	NN
KMRIM	NN
XDFH	JJ
AWCR	NN
SRGII	NNP
TMIMI	JJT
LEWDD	VB
BXIRTH	NN
LHWKIX	VB
BXINTNW	NN
KDAIWT	NNT
RCWNN	NN
RCWNM	NN
HMWLT	NNT
RCWNI	NN
RCWNW	NN
HMWLH	NN
NRDPIM	NN
MGBIR	VB
IXSMW	VB
MGBIT	NN
XSINWT	NN
HIEDR	NNT
ZWLTW	NN
NQRAT	VB
PFWJWT	JJ
HCJWPPW	VB
BIMAI	NNT
RWIAL	NNP
BITURI	JJ
PRIMIJIBIT	JJ
IIPLA	VB
IFRH	JJ
FUS	NNP
QDIF	NN
MWTNH	VB
BQEH	NN
NZQ	NN
FUX	NN
IARKW	VB
GFFIM	NN
HMLJ	NNP
AMRIQAIWT	JJ
HRGIF	VB
FWDD	NN
AINDWNZIH	NNP
TRDMTM	NN
FWDR	VB
HBDLI	NNT
MWNXI	NNT
IMINH	RB
BWRLI	NNP
MILNR	NNP
FBRIM	NN
BICI	NNT
GWBH	NNT
MTAMC	VB
EIFWN	NN
BICE	VB
MIHM	QW
MIHR	VB
MFTNIM	JJ
FIGR	VB
MIHW	QW
ALIPWIWT	NNT
ARMSJRWNG	NNP
IMINW	NN
KIBWFIHM	NN
EMWTT	NNT
TFALW	VB
GRBWZ	NNP
DMWTW	NN
IKWLTW	NN
MINIAPWLIS	NNP
ZWGN	NN
FBITH	NN
XWIBW	VB
IKWLTH	NN
DMWTH	NN
DMWTK	NN
EMWTH	NN
LMPRE	RB
TMCIT	NNT
HNXNW	VB
FTIIM	CD
MTNXLIM	NN
NRFM	VB
AWQRAINH	NNP
MFTTP	VB
NWCXH	VB
KLPI	IN
451	CD
MWNXT	VB
NJTH	VB
MIQRQSIM	NNP
NAGTWLLH	NNP
HIDRDRWT	NN
JBE	NN
MMFIK	VB
QRIT	NNT
IQFH	VB
FIEWRIM	NN
MWCLXIM	JJ
MCLMIM	VB
DGF	NN
BWGRWT	JJ
LHIJWTM	NN
NJWF	VB
AXDWT	JJ
CIBWRI	JJ
QTWLI	JJ
HCBIEW	VB
DGM	NN
HCBIEH	VB
JWRNH	NNP
MRADWNH	NNP
AIILWT	NNP
DMI	NNT
NWCRW	VB
ICIRTM	NN
BRANDJ	NNP
QPDNI	JJ
HERH	NN
FXWRI	NNT
JEMW	NN
HERB	RB
PNWI	JJ
QRIM	JJ
JENWT	NN
EWSQT	VB
TNHL	VB
ALWWARW	NNP
MKTBIM	NN
TEFIITI	JJ
JEMH	NN
NWBEWT	VB
SNJR	NN
HIPWKWNDR	NN
ITN	VB
LHJBIE	VB
QRBN	NN
QWALICIWNIIM	JJ
HWFMJ	VB
QRBJ	NNP
QRBH	VB
MZHH	VB
QRBT	NNT
SIMWLCIH	NN
HWFMW	VB
MRWKZT	JJ
ITR	NN
ECMWT	NNT
ITRWNW	NN
HKREWT	NN
MTEWRRWT	VB
ERKW	VB
GILWP	NN
ZMIN	JJ
HEWNH	RB
LCAT	VB
NSXP	VB
MJMIEH	VB
NMSRH	VB
LMCER	RB
GILWI	NN
ELI	IN
IGIF	VB
IGIE	VB
ERKH	VB
BELWT	NNT
ITRWNM	NN
ERKM	NN
SWRRIM	JJ
XWZRIM	VB
BIN	IN
BIL	NNP
IQFW	VB
MIIXS	VB
BIH	RB
MPLST	VB
BIB	NNT
JIIM	NNP
LHINQJ	VB
JIIS	NN
NWBLH	NN
FWLLT	VB
WWRIACIH	NN
LHIFME	VB
HTAWFFW	VB
BIT	NNT
BIR	NNP
ASTJI	JJ
TLWNWT	NN
IXLWP	VB
LHFQIP	VB
MWFLM	JJ
ACJJ	NN
MSGD	NN
01	CD
MISWD	NNT
HISPANI	JJ
MISWI	NN
SLE	NNT
CWEDT	VB
TBIA	VB
MECRW	NN
HIPK	NN
RXWBWTIH	NN
MSWGLT	VB
NIPCW	VB
MCD	IN
MCB	NN
MCA	VB
MTAR	VB
1,350	CD
RWGZ	NN
AIFIWTK	NN
MBRRT	VB
XIILIM	NN
GFM	NNT
HWGDR	VB
08	CD
AIFIIM	JJ
LHMXIF	VB
LQX	NN
PRWJQCIH	NN
MBCEIT	JJ
DWWQA	MOD
LQH	VB
MBCEIM	VB
AQDMI	JJ
NCXI	JJ
DLPQ	NN
TIIRWT	NN
HFLIM	VB
MDINIWTH	NN
HIRBTH	VB
FLIJTM	NN
DIWWIZIWT	NNT
FWPRSL	NNP
NCXIT	JJ
HWKXH	NN
MDINIWTW	NN
TERWKH	NN
LHRJIJ	VB
AZWRIWT	JJ
DISNILND	NNP
MNKUL	NNT
BEQBWT	IN
XFWD	NN
NFLXH	VB
BJWXH	JJ
RWMUH	NNP
NFLXW	VB
LKTWB	VB
MIUL	NN
LHCLIX	VB
IWGFW	VB
HCIGH	VB
BIQWRTI	JJ
QJL	NN
LHTPEL	VB
QJN	JJ
MKRW	VB
TWSIP	VB
AIZWFHI	DT
LEG	NN
TXQIR	NN
LEITIM	MOD
GIDI	NNP
EMWSIM	VB
KIM	NN
KDWRID	NN
MECRM	NN
QDWFH	JJ
KDWRIM	NN
HCIGW	VB
KSPIT	JJ
XRM	NN
HBRPLD	NNP
LSMWK	VB
CRW	VB
MBJAH	NN
ABJUA	NNP
HZDQQWT	NN
SIPR	VB
MWMLC	VB
BLILH	NN
KSPIM	NN
CRH	JJ
GWRRT	VB
LFTWT	VB
BAQRAI	RB
PS	NNP
THWDH	NN
MTXMQT	VB
TINWQT	NN
NINW	NNP
HFTRE	VB
ERBWT	NN
HTRWCCWT	NN
QPCW	VB
NMLJH	VB
FBITTM	NN
NMLJW	VB
NMLJT	VB
PG	VB
MWRIC	NNP
IWBRR	VB
PNQSK	NN
PH	RB
MWECWT	NN
PN	NN
SWBSIDIWT	NN
HFTRR	VB
FKWNTI	NN
FQDIM	NN
HERKWT	NN
MSQNH	NN
MMLKTI	JJ
LHEMIDH	VB
CBA	NN
HELAT	NNT
MSWRTIIM	JJ
QFWXIM	JJ
HWKRXW	VB
TLWIH	VB
GIIMS	NNP
KPRH	NN
P.	NNP
AWWRWR	NN
NBDQ	VB
NKXW	VB
PLIJI	NNT
MRWAIINIM	NN
ITWMI	NNT
RMTM	NN
FWRCQWP	NNP
SPRW	NN
DIIQNWTW	NN
AFTW	NN
NQWDH	NN
MKIR	VB
NQWDT	NNT
QICWNIWT	JJ
SPRH	NN
HTENIINWT	NN
NBDL	VB
129.90	CD
QRQEIT	JJ
MTWART	VB
TWBE	NN
EIIP	JJ
PGIFH	NN
TWBA	VB
575	CD
MFMRWT	NN
GWMHWR	NNP
TTAKSN	VB
HWBLT	NNT
AMITIWT	JJ
MWGZM	JJ
PGIFT	NNT
BIQFW	VB
MRFMIM	NN
XMIM	JJ
HGM	IN
HSTLQWT	NN
SIJWNAI	NNT
AWLRIK	NNP
HLWIIT	NNT
8.3	CD
8.5	CD
KMWSIM	JJ
RAFIIM	JJ
AWXZ	VB
BMQBIL	IN
MQFR	VB
KWWNWT	NN
ARIZWNH	NNP
AISWP	NNT
DRMJI	JJ
GIBWRI	NNT
FAPTNWT	NN
SIMNIM	NN
NAJUW	NNP
HXLIMW	VB
PIBRWQ	NNT
TFLWMI	NNT
GIBWRW	NN
586	CD
MWRGFT	VB
ICRNIM	NN
MXWZWT	NN
KXWLH	JJ
SIDR	VB
HPGNTIWT	NN
LRNR	NNP
PIGR	VB
HGMFT	NNT
LEWLM	RB
CMITWT	NN
BZBZNIT	JJ
MKRET	JJ
IIERK	VB
MFTPIM	VB
PRIDMN	NNP
ELIH	NN
MTNFA	VB
SIKNW	VB
ELIT	NN
MIFNHW	PRP
HDGIFW	VB
ECWBIM	JJ
TQCIBIT	JJ
NPTXH	VB
SWKNWTW	NN
PGANIWT	NN
GIAWLWG	JJ
BNIGWD	IN
KWWIITIIM	JJ
LHTXIL	VB
RGEIM	NN
LHTDIIN	VB
MWKFRIM	NN
NWSEIM	NN
RGEIT	JJ
TWPST	VB
NPTXT	VB
NDWDI	NNT
QWMTW	NN
MXIIB	VB
FXWRIM	NN
ALIAB	NNP
MWSDWT	NNT
XMWRH	JJ
ZKH	VB
FBIEWT	NNT
MXLCT	VB
TCLWMI	NNT
QWDMW	NN
HLKNW	VB
GWBR	VB
QWDMT	JJ
HDPIS	VB
ESQIIM	JJ
ZKW	VB
XMWRW	NN
ZKR	NN
MSWRTI	JJ
NQMT	NNT
QWMQWMIM	NN
SBWRH	VB
IJLW	VB
XIPFW	VB
KBWL	VB
MXWZQWT	VB
MCDH	NNP
LRBWT	IN
MRAWT	VB
HTERBWTW	NN
NQMH	NN
KBWD	NN
HFMJT	VB
DLQWT	NN
LMFL	RB
GWZP	NNP
HPCT	NNT
QWBL	NNP
XWZR	VB
PICWL	NN
PNQIIBIC	NNP
QWBH	NNP
TWMRIN	NNP
PRIXTM	NN
QWBE	VB
FIXQW	VB
MTECM	JJ
AFRAI	NN
BINLAWMI	JJ
MAZINIM	NN
MRDNIWT	JJ
FIXQH	VB
DRIQS	NNP
TMWTH	NN
10117	CD
XWZI	NNT
XWZH	NN
HDWQ	JJ
HDWR	JJ
LAHWB	VB
FPILD	NNP
MWGDRIM	VB
HTLQXWT	NN
IPRWC	VB
LWMD	VB
BCL	NN
TSKWLIHM	NN
LHIBXR	VB
MNHJN	NNP
MWXLJ	JJ
LBRWX	VB
MEMSH	NN
HGBLWT	NN
FIJWT	NN
FIJWR	NN
TNUK	NNP
TGWBWT	NN
GRWEIM	JJ
LIGH	NN
ERBIWT	JJ
TNUC	NN
LIGT	NNT
WWRFH	NNP
LHXIWT	VB
FNTW	NN
MWSIP	VB
XAN	NNP
MITQPH	NN
HFIG	VB
TPEWLH	NN
FWQRWN	NNP
HBLIH	NN
HBLIJ	VB
NACIM	NN
LXWLL	VB
SNSACIH	NN
HBLIE	VB
LSLQ	VB
MRFIMH	JJ
BLEDIT	JJ
NHWGH	VB
540,000	CD
HTRXFW	VB
IIKNSW	VB
HFIB	VB
NACIT	JJ
KDWRSLN	NNT
SNAJWRIM	NN
GNIM	NN
GNIN	NNP
HLLW	JJ
AIFH	NN
AIFI	JJ
NISWIIM	NN
HWBSW	VB
ARCIFRALI	JJ
LIRJH	NN
TCLIX	VB
LHMFIK	VB
DWBR	NNT
HERTI	VB
AIFR	VB
XIBWRI	NNT
BHTXFB	IN
TXWFH	NN
HKNSTM	NN
ERKAWT	NN
NQLET	VB
HFEIH	NN
HKNSTW	NN
TXWFT	NNT
AINDIWWIDWALIWT	NN
MWFPLWT	JJ
AMWRWT	VB
XISWNIT	JJ
GIJAWT	NN
BSISW	NN
SWNIH	NNP
RIBWNWT	NN
LABD	VB
MHNHIGWT	NN
IAXL	VB
ZQWQ	VB
FXWQIM	JJ
MISJI	JJ
LHPSIQ	VB
FQWPH	JJ
LHWJH	VB
CPWNIWT	JJ
MFQWP	NN
HTPRCWT	NN
MQWRIT	JJ
MTENIIN	VB
BERK	MOD
BSISI	NNT
KWKBM	NN
HTAPFRH	VB
TWKNNW	VB
DWDW	NNP
HMWNI	NNT
KWKBA	NNP
HFTATH	VB
DWDI	NNT
BRWJW	NN
TWKNNH	VB
GREWN	NN
TIQI	NNT
ETWIIN	NN
DIRWTIHM	NN
DPNH	NN
GALJASRAI	NNP
ISKIMW	VB
LERWB	VB
TAWWTW	NN
IRDW	VB
HFTTQW	VB
LCWRK	IN
BLEA	NNP
IRDN	NNP
HRXQH	NN
CLIL	NN
ELTH	VB
PWNDMNJLISJ	NN
HFTLBWT	NN
HQJNT	NNT
JWEIM	VB
MSMKIM	NN
LHCJIID	VB
FWBH	JJT
TPIFH	NN
PLIAH	NN
TPIFT	NNT
GWBANI	NNP
9.1	CD
RFMIWT	JJ
MINH	VB
MINI	NNT
MXLWQT	NN
MJPXT	NNT
FIIK	JJ
IIWWCR	VB
AWNIWT	NN
MWFBH	NN
MAWPIINT	VB
MZINH	VB
MWFBW	NN
JKNIT	JJ
FIIX	NNP
MKSIQW	NNP
AWFRH	VB
MELIMIM	VB
RAWI	VB
FXIH	NN
NBEJH	VB
RXBEM	NNP
HNXWT	NN
EWZRIM	NN
LHIPK	RB
MPLCWT	NN
FIGWR	NNT
MTKWT	NN
PEWLWT	NNT
MILANW	NNP
RFMIIM	JJ
MMILA	RB
EWZRIW	NN
AISLMI	JJ
GI51	ZVL
CID	NNT
18.6	CD
MDRIDI	JJ
QFWRIM	VB
INKW	VB
CIR	NN
BINTIIM	RB
LKDI	IN
ASAM	NNP
MICTH	VB
MCLMWT	NN
DAG	VB
MIEWJIM	NN
RAFNW	NN
DAL	NNP
SWGI	NNT
BMAI	NN
SWGM	NN
MGLIM	VB
SWGR	VB
PINNSI	JJ
ECWRIM	VB
HPGNH	NN
FWLXN	NN
MTPQDIM	VB
PRSWM	NN
HWTR	RB
DAZ	MOD
NTINIW	NN
MACW	NN
LIZR	NNP
HFTDLW	VB
HTXTNH	VB
RWPAH	NN
FNIT	RB
XLXWL	NNP
HWSIP	VB
XGIGH	NN
XGIGI	JJ
MAWXRIM	JJ
NWBLGIN	NNP
MQBLT	VB
NDMH	VB
LHTBSS	VB
FNIH	JJ
BMFK	IN
FNIM	NN
LAIJH	RB
PRICT	NNT
99.90	CD
IHWDIWT	JJ
QWNWWNCIWNLIIM	JJ
HBJXWTIW	NN
HWDLP	VB
ALEZR	NNP
LPNWT	VB
HZMIN	VB
NJILT	NNT
XIPH	NNP
TWRPH	NN
IJH	VB
HPWKH	JJ
NIDRF	VB
MMHRIM	VB
FLJWN	NN
EREWRIM	NN
JKNWLWGI	JJ
AGB	RB
BIWRWQRJIH	NN
ERIM	NN
SIRNI	NNP
SIRNH	NN
ARCWT	NNT
XJIBWT	NN
AGP	NNT
BWQ	NNP
BWR	NNT
HRFW	VB
XWMWT	NN
FEMWM	NN
BIWRWQRJIT	JJ
RIJH	NNP
BWZ	NN
MEGL	NN
RGLIT	RB
RGLIW	NN
BWA	NNT
BWC	NNP
KLKLI	JJ
KLKLH	NN
EWLMNW	NN
LBNWT	VB
BHTAM	IN
KSPI	JJ
TRZH	NNP
XBWRT	NNT
BWN	NNP
TIIRIM	NN
JWS	NNP
EINIW	NN
TNEMI	NNP
IMNIWT	JJ
HIMWR	NN
HEMID	VB
LWNDWNI	JJ
SIJWACIH	NN
DRQSL	NNP
PWJRWT	VB
CWBRT	VB
GFRIM	NN
MAT	IN
MAZ	IN
SNJ	NN
LPIKK	RB
MWEDPT	JJ
2000	CD
MAD	MOD
RIBAWND	NNP
HKTIBW	VB
MAI	NNP
MAH	CD
NMHRWT	JJ
ITWGBRW	VB
MAM	NNP
HWGBL	VB
RWEH	NNT
MCWWH	VB
LHZNIX	VB
HRGFH	NN
NTNIITIM	NN
XBWRH	NN
ALBWMIM	NN
ALNBI	NNP
MTH	VB
DWWWX	VB
LPNIHM	IN
NAMN	JJ
HTLHB	VB
PJRWKIMIH	NN
CDM	NN
AIMWNIT	NN
3,512	CD
NMASH	VB
RIBEWWI	NNP
BWJL	VB
TQWWT	NNT
LHTGRF	VB
BWJH	JJ
LSJ	NNP
MRFIMIM	JJ
MARJIN	NNP
LST	NN
PRIDLNDR	NNP
XRWFT	NN
TQWWH	NN
XWWITI	VB
JBEIIM	JJ
NDIRWT	JJ
PARIS	NNP
MFTKRIM	VB
BWBWTIH	NN
TPWL	VB
DQIQ	JJ
MRDNI	JJ
LTLWT	VB
ZKIIH	NN
NML	NN
FMRNI	JJ
MTLWNNIM	VB
BITWR	NN
QHW	VB
HTLQXH	VB
HWQCH	VB
MINIMLIWT	JJ
PANIQH	NN
NMFKWT	VB
PIST	NNT
IJWS	VB
RIPWI	NN
QHL	NN
MEMDIT	JJ
LIBWBIC	NNP
AWSQR	NNP
MEWRB	VB
BIDWD	NN
CWER	NN
HPXT	NNT
NWBLWT	NN
HTMNH	VB
BIDWR	NN
AMTISJ	NNP
EKFIW	RB
JJRIT	JJ
LHTMWDD	VB
GWRLH	NN
MWTQPIM	VB
QRAWS	NNP
RPWRMH	NN
RPWRMI	JJ
GLZR	NNP
MWDEWT	NN
TQPWT	JJ
XWJPIM	NN
IFXRR	VB
HMCIAH	VB
PWRJW	NNP
HMCIAW	VB
NMDD	VB
MAFIM	VB
HFTPR	VB
HTNHGWT	NN
MWQM	VB
AIMWN	NN
IIDQR	VB
ZRIQT	NNT
KWLW	JJ
AIMWC	NNT
MGBILH	VB
MNHAJN	NNP
AIRIM	NN
IWZMNW	VB
NWSXAWT	NN
BIJAW	VB
XBILH	NN
IWDPSW	VB
JMPRJWRH	NN
MRGIEIM	VB
1991	CD
1990	CD
1994	CD
MIBCE	NNT
BLAI	NN
SIRQIN	NNP
CIWNI	JJ
33.90	CD
IPELW	VB
QICWNIIM	JJ
EWFRW	NN
MERICIM	NN
ICGW	VB
2.81	CD
IGRWM	VB
MIMWNW	NN
MWQP	VB
IAMCW	VB
550	CD
HRCAH	NN
QLSIT	JJ
8.35	CD
LHIMNE	VB
ATGRIM	NN
ADWQIM	JJ
ALKSNDRWNI	NNP
IGRWR	VB
MRQJIM	NN
FIQWLIW	NN
ABNR	NNP
WEDT	NNT
ARSIT	JJ
MXWFBIM	VB
MQDF	NNT
LHTELM	VB
MNDJ	NN
AWZN	NNP
AWZL	VB
QWNWWQJWRIM	NN
FIQWLIM	NN
BWKWM	NNP
MZERI	JJ
IKWLTM	NN
GLWSQA	NNP
MWSEIM	VB
FABW	VB
IERIM	NN
MABQIH	NN
BRSLB	NNP
MABQIM	NN
XIIBIM	VB
XUKIM	NN
NISINW	VB
AWPJIMI	JJ
MWPQR	JJ
IIPWL	VB
NPWC	VB
KWAB	VB
HBEWT	NNT
SBWN	NN
QBRWTIHM	NN
MQWLQLIM	VB
SIPQ	VB
MJR	NN
MRKZIWT	JJ
AGMI	NNP
MKIN	VB
BITURIWT	JJ
1,875	CD
QSJRW	NNP
DIKWI	NNT
DPWSIM	NN
FTIIH	NN
LHFPIE	VB
HIITH	VB
PIINL	NNP
DRMAJI	JJ
QRISTN	NN
NIERW	VB
7691	CD
HBNIIH	NN
HDBQH	NN
HFTQPWIWTIW	NN
ZIW	NNP
ZIT	NNP
MILQI	NNP
MFPJIWT	JJ
NPL	VB
MJRTM	NN
AITWT	NN
HRFIM	VB
MJRTH	NN
PXWTIM	JJ
HTIR	VB
MJRTW	NN
WJW	NN
KRMLH	NNP
MRBITM	NN
LRDT	VB
MDLIQ	VB
MRIRWT	NN
PTIXH	NN
KFRIM	JJ
LHEMID	VB
LZHWT	VB
LMDW	VB
LMDI	MOD
LMDH	VB
PTIXT	NNT
SNDWWIC	NNP
JARPLI	NNP
MDLIH	NN
IDWEWT	VB
NGBH	NNP
FWWRC	NNP
MINWIIM	NN
IEILWT	NNT
LHQPIA	VB
LHQPID	VB
IQWM	NN
DWBRIM	NN
EWLMWT	NN
MCWQH	NN
LSNR	NNP
NGBW	VB
HPEM	RB
AMNWT	NN
QHILH	NN
JRIIM	JJ
NICBT	VB
IMNEW	VB
HKRIZW	VB
MAWFPZ	VB
MNHLT	NNT
ABSWRDI	JJ
GLIMWT	NN
MFMF	VB
MNHLH	NN
MNHLI	NNT
NCIGWIWT	NNT
FIXWT	NN
NICBH	VB
AMNWN	NNP
QHILT	NNT
AWBIIQJIWWI	JJ
RAFWNIM	JJ
MZHMIM	VB
TNSH	VB
XFBTI	VB
BLEDIWT	JJ
LRAFWNH	RB
MFTMFIM	VB
NHWGIM	JJ
NAXZ	VB
FWNIM	JJ
TSKWLW	NN
ICIRTW	NN
LIMWD	NN
GWAJMALH	NNP
MEWRR	VB
NWCRI	JJ
PJWRH	VB
ENP	NNT
97125480	CD
HTNGD	VB
XCI	NNT
NWRMN	NNP
XCR	NN
AIZWRIT	JJ
SRSWR	NNT
MWSQWBIC	NNP
ZHBH	NNP
MFJRT	NNT
LHIPQX	VB
ITGLW	VB
SLJIQ	NNP
EWCMH	NN
HTQIIMH	VB
MLBSQI	NNP
BRIKWT	NN
MTKWWN	VB
EWCMT	NNT
NQREW	VB
MGWWNT	VB
TRGILIM	NN
LIBRLI	JJ
JEMIM	NN
HTXIIBWT	NN
MIGWN	NN
MWCIAIM	NN
TWQJN	VB
CIPIWT	NN
EZIBT	NNT
HTNXLW	VB
AMWNIM	NN
HTMWJJWT	NN
BRKTI	VB
TPLWT	NN
DWLRIT	JJ
MQWRWT	NN
B	IN
IXSIT	RB
IXSIW	NN
FBEIM	CD
JJRIIM	JJ
JIPWSI	JJ
814	CD
NKNS	VB
FPXH	NN
HRWG	NN
DWLRIM	NN
IXSIM	NN
NCIGIM	NN
TUQ	CD
MKWNIWT	NN
MQFRT	VB
TQNWN	NNT
EQRWNIT	JJ
MWBIL	NN
TQNWT	NN
TUA	NNP
8591	CD
QWPUX	NN
SPWLDING	NNP
LQXT	VB
LQXW	VB
SNJH	NNP
MENIQH	VB
PWLISWT	NNT
RDIW	NN
MGWRIM	NN
DWRJMWND	NNP
IWXLJ	VB
MGWRIW	NN
SPRDIM	NN
LQXH	VB
HCLH	NN
5.0	CD
NAMNWTW	NN
Q.	NNP
CLMIM	NN
NLEG	JJ
ALWNI	NNP
SMWK	RB
EQWMH	NN
NTQEW	VB
LNAWM	VB
LAWJNBRG	NNP
DWXIM	VB
PWTX	VB
RIKWZI	JJ
ITGFM	VB
APFRIWT	JJ
ABSWLWJIT	JJ
TXRWTI	JJ
GLWMWT	VB
400,000	CD
ANWF	NN
LBFW	VB
NERKW	VB
803	CD
MTNUSIM	NN
NERKT	VB
PGIEH	NN
SKIN	NN
LWBI	NN
ALPI	CDT
MILH	NN
AMRWTIHM	NN
TQIN	JJ
PIGWARDW	NNP
GWMLIN	NN
QR	JJ
QT	NNT
QW	NN
MMDIW	NN
QLWFIM	JJ
BRWNZH	NN
RPAUL	NNP
QSM	NN
QSL	NNP
XILWNIM	NN
QC	NN
QF	NN
MTQN	VB
IWEMDW	VB
QM	VB
QL	JJ
TQIP	JJ
TNWRI	NNT
FLFWL	NN
PAS	NNP
GLWLH	NN
MHWWH	AUX
FLFWM	RB
MWQDMIM	VB
CRPTIWT	NN
HTRXFWTM	NN
HTAXDWT	NN
PAB	NN
XIZWR	NN
7.6	CD
DQIRH	NN
PRIDH	NN
ZWHI	PRP
QWBLIM	VB
MPWJRIM	NN
HTQFRWTW	NN
PWRQH	VB
FIGRW	VB
RXWB	NNT
PWRQN	NN
XZIR	NN
XZIT	NN
LFBF	VB
MWSRI	JJ
FLWMIT	NNP
MSNNT	NN
HFKIRH	VB
SWER	JJ
LFBT	VB
FIGRH	VB
FMIM	NN
SIJWNI	JJ
AMNWTI	JJ
TTBCE	VB
MDINIWT	NN
QPIJL	NNP
HFIMW	VB
SGNW	NN
25,000	CD
CIJWJ	NNT
BLWM	JJ
LPWCC	VB
IZREAL	NNP
STIRH	NN
CEIRIM	NN
SNDINISJIM	JJ
TWMNW	NN
FLWFH	CD
MQWMWNIM	NN
RBWT	JJ
FLWFT	CDT
SNDINISJIT	JJ
AWRWGWWAI	NNP
HDDIT	JJ
IHA	VB
NWGEWT	VB
MWRFEI	NNT
MSIIRT	VB
KPR	NNT
GBI	NNT
FKBWT	NN
MIQPTMWNH1	ZVL
GBT	NNP
RIKWZIWT	JJ
GBR	NN
HGINWTW	NN
MERBI	JJ
SLMINH	NNP
DIKAWN	NN
MERBB	VB
LZRWM	VB
BZBWZ	NNT
RIDN	NNP
MFWPE	JJ
ITWM	JJ
HSTIIM	VB
EICWB	NN
AMWNTW	NN
CEIPIM	NN
TEMID	VB
AWBDN	NNT
MFWPR	JJ
SMWIH	JJ
HDRGTIIM	JJ
BJXWNH	NN
LHCMID	VB
NPRDW	VB
XFDNWT	NN
PILIP	NNP
NKPPW	VB
ALKSNDRS	NNP
RGILH	JJ
ERIKT	NNT
HTNGDWTH	NN
LZRWE	VB
LHCMIT	VB
MCJRP	VB
AMWCIWNLIT	JJ
MWR	NNP
ICIEIM	NN
XLWPI	JJ
NPRDH	VB
NHAR	NNP
SJIWT	NN
WWHBH	NNP
NSIETW	NN
SWRDI	NNP
FRIRIWT	JJ
JQSJ	NN
GZZT	NN
JQSI	NNT
HITH	AUX
RWKF	VB
MAKZBWT	JJ
LQWWT	VB
MWLDTW	NN
RWKB	VB
HTXZQW	VB
MECMWT	NNT
TWKXT	NNT
IIFMW	VB
HTQFH	VB
XSINWTW	NN
LMNWT	VB
BHKRX	RB
KMH	DT
KMW	IN
RMDAN	NN
XFWBH	JJ
MZWIPT	JJ
KDWREP	NN
LMNWE	VB
SIKWN	NN
IIFMH	VB
LHZKIR	VB
HTQFR	VB
SIKWI	NN
HTXZQH	VB
PWRJWGL	NNP
BWHW	NN
BWHQ	NN
HIQNW	VB
ITGWRRW	VB
QIIMA	NN
IPRGNW	VB
BWHZ	NNP
QFWT	JJ
PJIRTW	NN
LWNDWN	NNP
NHLIM	NN
QIIMT	JJ
QIIMW	VB
TFIM	VB
NIHILISJI	JJ
AKZBWT	NN
MWBILIM	VB
QIJWB	NN
EWRRW	VB
IRWFLMI	JJ
AWXZIM	VB
XFBWNWTIW	NN
BNWSP	IN
MFWTP	JJ
RIIKMN	NNP
HKFILW	VB
ANDWQRINWLWGIH	NN
QFWR	VB
MEIDH	VB
EWRRH	VB
NMNW	VB
QNW	VB
HWQMH	VB
QNS	NN
MSRBT	VB
HTQIIM	VB
NQRA	VB
BITUR	NNP
ANXWT	NN
WIQJWRI	NNP
PFWJH	JJ
KLBIHM	NN
HTQIIR	VB
EWCR	NN
MTXILH	VB
HWQMW	VB
NQRW	VB
HWNPQW	VB
QNH	NN
NMNH	VB
QNJ	NNP
BGUC	NNP
MSIIRIM	VB
AJRQJIWWIM	JJ
MPWQPQ	JJ
GMLAWT	NN
FRWN	NNP
QWMNDW	NNT
MNJLIWT	NN
EITWI	NN
FRWT	NNT
XIWWR	JJ
RIKWZ	NN
IFRWR	VB
PIJWRIN	NN
WNCWALH	NNP
LHTRKZ	VB
QJIGWRIWT	NN
HQRNWT	NN
MFLXT	NN
NXTMW	VB
IEBDW	VB
DRMH	NN
RFAIWT	VB
QHILTIIM	JJ
NPLAIM	JJ
MRTP	NNT
FKWNWT	NN
MBWGRIM	NN
MSWKNWT	JJ
ZWLLI	JJT
MFXRRIM	VB
MPWRFT	JJ
MLEIJIM	VB
LIIBWR	NNP
IICWR	NN
QDWFIM	NN
FMRH	VB
IFRALIM	JJ
LNWX	VB
ECMW	PRP
1975	CD
MGMTW	NN
KISW	NN
MWDE	VB
ECMN	PRP
ECMM	PRP
ECMK	PRP
ECMI	PRP
ECMH	PRP
HWPIE	VB
XFWDIM	NN
IRIBW	NN
FMRW	VB
BLGAN	NN
IWKI	NNP
MDQDQWT	VB
IWKL	VB
FIIQH	NNP
GIBFH	VB
SWKNWIWT	NNT
BKLL	MOD
MSPRIM	NN
QAWL	NNP
CWMCMW	VB
REIFWT	NN
TWPRWT	NN
TWFB	NNT
PTWXWT	JJ
MXWQQ	NN
PINNSIT	JJ
LHIMLJ	VB
IHWDIIH	JJ
SGIDH	NN
HLQAH	NN
NALCH	VB
TBE	VB
MBIEH	VB
LHTEJP	VB
AWTW	DT
CIMQ	VB
HJRID	VB
HWCAWT	NN
MIWXLT	JJ
AWTN	DT
BLAQMN	NNP
AWTH	DT
38	CD
MINIMWM	NN
QWCR	NNT
HIDRWGNCIH	NN
NALCW	VB
PCWEH	VB
MWRKB	JJ
PALAS	NNP
NIBA	VB
IFAIR	VB
CXQ	VB
MRWM	NNT
IXIDWTIHM	NN
AIJLQIT	JJ
BIMWIM	NN
HTIIXSWT	NN
NTPST	VB
HWMRI	JJ
PWGEIM	VB
MAPIWT	NN
MINIWTN	NN
SWCIALIWT	JJ
HFGXH	NN
LHTNCL	VB
IIEWL	NN
NISIWNW	NN
WMWNJH	NNP
IIEWC	NN
HTXFBWT	NN
LXPF	VB
536	CD
KTBW	VB
QIDWM	NN
531	CD
HWMWRISJIIM	JJ
QIDWF	NNT
BI.	NNP
JILPNTI	VB
QLSIQH	NN
LAXRWNH	RB
FWXRI	NNT
FLBIM	NN
PAIZ	NNP
REB	NN
SNIQRS	NNP
TIQ	NNT
EBIRT	NNT
NRCXW	VB
MABWJ	NNP
NGIXH	NN
ZRIM	NN
NMRC	JJ
MKRIE	JJ
IHWDIM	NN
IHWDIH	JJ
MKRIM	NN
HARXH	NN
LHFTNWT	VB
CWIN	VB
MIJWWX	NN
RBI	NN
RWXMH	NNP
IHWDIT	JJ
MKRIX	VB
NWTQP	VB
MKRIZ	VB
HTKH	NN
SWGIM	NN
MILWI	NN
QWNPDRJIWWIIM	JJ
HKIR	VB
SWGIH	NN
TDWWX	VB
MILWA	NNP
MHWLLT	JJ
MFWKNE	VB
FQAR	NNP
XIWNIWT	NN
HILWWAN	NNP
NSGRT	VB
RBH	JJ
CXI	NNP
HPGNWT	NN
FQAF	NNP
SKRT	NN
MRXIQT	JJT
QIBWCIT	JJ
HWPKT	VB
PLAJWT	NN
IWGDRW	VB
QWNDS	NN
AWHBIM	VB
BTIM	NN
WQPKWT	ZVL
ANJIFMI	JJ
HFQPT	NNT
MFIMT	NNT
NXLQT	VB
MXRID	JJ
MWTIRIM	VB
MFIMH	NN
MSTWRIN	NN
HDSH	NN
MWFXTT	JJ
HFQPH	NN
XZRH	NN
JRIWQ	NNP
ELIITM	NN
SGNWNW	NN
21.9	CD
PWRC	VB
XWQRI	NNT
ATA	NNP
XWQRT	VB
GWRDWN	NNP
HQPID	VB
IIBNH	VB
ELIITW	NN
HQPIC	VB
XZRW	VB
MWSMK	NNT
RWMNJI	JJ
DIDAQJI	JJ
LICN	NN
KDAI	VB
BRWM	NN
TIKWN	JJ
BRWN	NN
PRJNRIM	NN
BRWK	NNP
HEDRWT	NN
FBUS	NN
MTQBLT	VB
BRWR	JJ
NGZRW	VB
AIBRHIM	NNP
LHJIL	VB
HTNER	VB
MFWGE	NN
LWMDIM	VB
QIRBTM	NN
HIEDRM	NN
SPWRWT	JJ
NFPJW	VB
AIFIWTW	NN
NWPX	VB
BNIHM	NN
MCE	NNT
NJIWT	NN
PWREIM	NN
XSIMH	NN
MNWGDWT	JJ
JRIBIWN	NNP
HPGINW	VB
FINNTI	VB
TWK	IN
LPXD	VB
IIXWDIIM	JJ
TWM	NNT
TWR	NN
MPIQ	VB
AIBD	VB
PSILT	NNT
PNJSIWT	NN
AIBH	NN
NABQT	VB
NABQW	VB
KWLLNI	JJ
AINDIANH	NNP
MNHG	NN
MFNTW	NN
TABD	VB
HNIE	VB
AMWNH	NN
GDWFH	JJ
MFWRRIM	NN
AIFIWTM	NN
GIFTM	NN
ERWKWT	VB
HFTTPWTM	NN
AGRWP	NN
XDLH	VB
RDIPT	NNT
CBIETW	NN
XSM	NN
HNIX	VB
FLWFIM	CD
MXSWR	NN
SWKNIM	NN
AXRIM	JJ
XBRIH	NN
MTGWRR	VB
ENIIN	NN
MDRFIM	NN
MAWREWT	NN
AXRIT	NNT
CHWBIM	JJ
MNWRT	NNT
XBRIW	NN
AINKM	RB
MRKIBI	NNT
EKBRI	NNT
MSXR	NN
FBXIM	NN
RXMIM	NN
RWWXT	JJ
GIWS	NNT
MXSWM	NN
ZIGWG	NN
SPCIPIT	RB
WWRN	NNP
PNJWMIMH	NN
HRUI	NNP
SINNW	VB
MPQPQ	VB
SJJISJIQH	NN
DWUXWT	NN
NMKRWT	VB
JWAJAW	VB
RAWIIM	VB
QWPWT	NNT
BRWNW	NNP
ABNIM	NN
FJRIT	NNP
RIBLIN	NNP
MBCEIWT	JJ
TNAIHN	NN
35.5	CD
QMIM	VB
7001	CD
QDWF	NNP
TRWPH	NN
HTIIECWIWT	NN
MTWGBR	VB
IDWEH	JJ
MWZNIM	VB
TWQPIM	NN
ZWEQIM	VB
HMFK	NN
SMLI	NNT
ECWBH	JJ
NLKD	VB
HFKILH	VB
yyLRB	yyLRB
LEBR	IN
MGEIM	NN
BIJRN	NNP
RFTWT	NNT
KINRT	NN
PRWIND	NNP
DGL	NN
IFNWT	JJ
HTMWDDWT	NN
FALTI	VB
891	CD
LGBWT	VB
LGBWR	VB
FIMF	VB
MAPFRIM	VB
DQRW	VB
MENQIM	NN
LAWRK	IN
MKRIZIM	VB
LAWRH	NNP
LBDH	MOD
LHPSID	VB
LBDW	RB
MMDIWT	JJ
MFBR	NN
MDWWXIM	VB
TQWM	VB
TQWH	NN
HTXIIB	VB
JBEIT	JJ
IQRH	VB
GMLH	VB
LHTNQF	VB
MRWT	NN
EFWIH	VB
SWGIHM	NN
MTNHLWT	VB
MRWN	NNP
FKNH	NN
TWRTW	NN
EMIDWT	NN
CMX	VB
CMW	NNP
CMR	NN
AIDIAWLWG	NN
PCE	VB
BMEJ	RB
LQRAT	IN
KHNISJI	JJ
SJ	NNP
HFGT	NNT
PRIFH	NN
FLWM	NN
HWPC	VB
PIQDWN	NN
TIQRA	VB
MXWKMIM	JJ
HWPK	VB
PQDH	VB
PWRSM	VB
SJWQJWN	NNP
CWRWT	NN
SN	NNP
MKWNITW	NN
SM	NNP
MAGR	NNT
PNIW	NN
FKXTI	VB
MDRGWT	NN
PNIM	NN
MITWLWGIH	NN
MTED	VB
MWKIX	VB
PNIK	NN
MWEMD	NN
IILMAZ	NNP
QIPWX	NN
6,000	CD
GBWLWTIH	NN
EFWI	VB
GRWSMN	NNP
BWDD	JJ
MLQWLM	NNP
NICXL	VB
GBIE	NNT
DRIKWT	NN
HWPTE	VB
JILPN	VB
MAWFR	JJ
SE	NNP
MWBJX	VB
TCPIT	NN
GLI	NNT
FPAIIR	NNP
CRIKH	VB
GLM	NN
BTWLI	NNT
RIALISJIT	JJ
9.13	CD
9.11	CD
DWRSWN	NNP
AKN	RB
FMIIM	NN
HWKXT	NNT
KWLNW	PRP
BWDQ	VB
QLPIM	NN
LHQDIM	VB
MFDRT	VB
PJMH	NNP
HWPSQW	VB
QLPIF	NNP
JIWX	NN
EILWM	NNT
SMWKH	JJ
ITQE	VB
GZIRH	NN
MECR	NN
MXSWMIM	NN
MFWRR	NN
JIWL	NN
LHSTIIM	VB
DWMWT	JJ
MBQRIW	NN
QCINI	NNT
MXSNIM	NN
HCIPWIIIM	ZVL
F	REL
MNWWJ	VB
NWPXH	VB
SWCIALISJI	JJ
HIBJIM	NN
HNXIITW	NN
SBSWD	NN
BEQBWTI	IN
IHSSW	VB
MKWPPT	VB
MBQRIM	NN
MWLIK	VB
IIPGFW	VB
MWLIN	NNP
MXSNIT	NN
MXLH	NN
RMZWRIM	NN
MMFLTNW	NN
AQSPWZICIH	NN
PEILI	NNT
LHIXFP	VB
KNRAH	RB
FMWRH	NN
ARBEIM	CD
BMHLK	IN
SNQCIWT	NN
NISIWN	NN
SNIPI	NNT
SNIPH	NN
MMN	IN
LHIXFB	VB
XFAIIM	JJ
MMD	NN
SNDRLND	NNP
MMF	RB
MZKUL	NNT
SBL	VB
AXWZTW	NN
XSIN	JJ
MQWCR	JJ
XWZRT	VB
XSID	NNT
MPQDIH	NN
AJLNJH	NNP
WAJNFIID	NNP
ERF	NNT
HMRIA	VB
ERB	NN
WLDIMIR	NNP
MQCWE	NN
ERI	NNT
ERK	NN
WWLDRIDG	NNP
MFMXT	VB
MTWXKM	JJ
EIQWLIM	NN
RISQI	NNP
LHTPWRR	VB
PLIJIM	NN
MWAC	JJ
MXZIQWT	NNT
BRIIJMN	NNP
KAWBH	JJ
BWNH	NN
NMWKH	JJ
HFAIRW	VB
HTGWNNWT	NN
PGF	VB
LHPNWT	VB
RWMANIM	NN
5.1	CD
PRJI	JJ
BEIIT	NNT
AJWMI	JJ
LWQACR	NNP
ALRGI	JJ
NWQFWTW	NN
NPXW	NN
BEIIH	NN
MKFIRIHM	NN
LWWIH	NN
NMHR	JJ
PWFEIM	NN
PIWS	NN
NTPSH	VB
PARMH	NNP
NTGLH	VB
QRIWT	NNP
NWPLIM	VB
QLP	NNT
QLN	NNP
SQRI	NNT
QLJ	VB
FETIIM	NN
QLH	JJ
QLE	VB
MTPLLIM	NN
HITRIM	NN
LFWKRH	RB
FWWIG	NNP
HMLCH	NN
FWWIC	NNP
HXMICW	VB
FWWIM	JJ
BXIRH	NN
FWWIH	NN
BXIRT	NNT
CPIRWT	NNT
BRWRWT	JJ
JBLH	NN
XRWM	NN
HMLCT	NNT
HGIX	VB
AILMIM	NN
HWQCBW	VB
RQ	MOD
RS	NNP
BDRNINW	NN
QASBH	NN
MEWPPWT	NNT
ABWT	NN
RZ	NNP
HFTTP	VB
RE	JJ
HTRBW	VB
MWJEIM	JJ
2151	CD
RB	JJ
RC	VB
RM	NNP
HGIB	VB
ABWD	JJ
HGIE	VB
HGIF	VB
CWRKI	NNT
APFRI	JJ
ZKWRH	VB
ZHIRH	JJ
EMDH	NN
LMDNW	VB
HBNH	NN
HFTKRWTM	NN
KWRDIT	JJ
HBNT	NNT
MQRWB	RB
EMDW	VB
EMDT	NNT
QARD	NN
KDWRIW	NN
R.	NNP
AIWMH	JJ
FMLT	NNT
LTAR	VB
HTLHBW	VB
IDIT	NNT
DT	NN
MDRGH	NN
IDIH	NN
KICD	QW
BJLH	VB
22.5	CD
NAGJS	NNP
025055	CD
LTAM	VB
IDID	NN
MTPFR	JJ
AIZH	WDT
SIJI	NNP
IWUR	NNT
LKT	NN
HWBJX	VB
ALKS	NNP
QJE	NN
HRGW	VB
AMITIIM	JJ
HZNH	NN
TWHH	JJ
MTPFJ	VB
NWXIM	JJ
HTPFRWT	NN
HERKT	NNT
MWFEIM	JJ
MKTBH	NN
MBIKH	VB
HIMWRIM	NN
MFLXWT	NNT
XMCN	NN
ALMWNIWTW	NN
CRKNIWT	NN
HGBRT	NNT
NALC	VB
MRWCIM	JJ
HETQH	NN
QNITI	VB
SHRH	NNP
IEZWR	VB
MRFIM	VB
MKNIZM	NN
HETQT	NNT
QWNBQJWRIM	NN
AGTNWR	NNT
MTBHR	VB
FWLIIM	NN
NPSQ	VB
XIIQWL	NNP
MXRTIIM	RB
MPIQIM	VB
HTNHGWTW	NN
JLPWNI	JJ
WALIWM	NNP
519	CD
HTNHGWTM	NN
HTNHGWTH	NN
TWTIR	VB
511	CD
IIZKR	VB
BIQWRTW	NN
MIWTR	JJ
516	CD
MCBN	NN
RDPW	VB
MCBM	NN
DWPQ	NNT
RWGBI	NNP
ZWLWT	JJ
FWLPIM	VB
SNIGWR	NN
EMID	JJ
DRGWT	NNT
BDRIAN	NNP
PILGRIMM	NNP
MILJWN	NNP
MCBW	NN
ILCIN	NNP
LHFTXRR	VB
DPWS	NN
LBCR	VB
HTNSWT	NN
NICXNW	VB
HNGBI	NNP
MMCAI	NNT
SIMN	NN
MNIBH	VB
MEWGL	JJ
HCJIIDWTH	NN
MXZIQIM	VB
DIRTH	NN
HWRAWT	NNT
FWXZRW	VB
MSWJ	NNP
FIPC	VB
PCEIW	NN
HESQT	NNT
DAWS	NNP
MXWIBWTW	NN
MRKIBIW	NN
IIWWTR	VB
RISRC	NNP
FCP	NN
GIWWN	NN
SPRIIH	NN
QAWPMN	NNP
FIPR	VB
MSXRI	JJ
LIWBWFIC	NNP
PCEIH	NN
MJRPT	JJ
GIBWRIW	NN
AWRLNDW	NNP
DQWT	NN
EMIR	NNP
GDEWNIM	NN
JWWH	VB
ZEH	NN
ENIINIT	JJ
AIJIPAQ	NNP
MXZQT	VB
MFXQIM	NN
MRAIM	VB
ENIINIM	NN
LHWSIP	VB
FWWIWN	NNT
MDMMIM	JJ
MNSRWT	NNT
JWWX	NN
HWLIWWDIWT	JJ
MCLIXIM	VB
CRIM	JJ
KSPIIM	JJ
HWZLWT	NN
MLXH	NNP
ETIQIM	JJ
MTRGFT	VB
MFIKH	NN
MWJXT	VB
FIPA	NNP
BNQAWT	NN
PRJ	NN
LSJR	NNP
PFRH	NN
PEILWIWT	NN
XWPF	NNT
0408	CD
HTEMLWT	NN
MEWDKNIM	JJ
MCWMCMT	JJ
ASIRIM	NN
MNBAIM	VB
MAZNW	NN
APIPIWR	NN
NPGE	VB
HWFALW	VB
XWDF	NN
TXWM	NNT
MWFQEWT	VB
EFIRI	JJ
EJWPH	VB
NDWNH	VB
RANGWN	NNP
BFWRH	NN
MFKWRTW	NN
LIAZ	NNP
RGLW	NN
TSIIE	VB
MTXW	VB
MFKWRTM	NN
CMDN	NN
MTXT	IN
BRQW	NNP
NELIM	NN
BRQT	NNP
EJWPT	JJT
ELWLH	VB
LIAH	NNP
XWTKT	VB
NWRIT	NNP
PT	NNP
NFIPH	NN
XGG	NNP
NMCAIM	VB
QRWNWT	NNT
HTHPK	VB
NWRIC	NNP
HAMBWRG	NNP
MRJIN	NNP
TTKWWN	VB
TXFWB	VB
HTNCL	VB
PRMIH	NN
LPZR	VB
KRJISI	NNT
TQL	VB
TQN	NN
MLAKTW	NN
LFGFG	VB
MEBIDW	NN
IEFH	VB
TQP	VB
NXFBIM	VB
KRJISW	NN
MEWDD	JJ
APFRWIWT	NN
ZNXW	VB
AWNRWWUA	NNP
5.11.90	CD
HCLXH	NN
QBIEWT	NN
KDWRI	NNT
MNCLIM	VB
MENIQIM	VB
MBFRT	VB
MIN	NN
LAWMNIT	JJ
EBRIT	NN
MZWIN	JJ
HLWWIWT	NNT
HWFMEW	VB
FWWRCMN	NNP
HWCAWTIHM	NN
ECWMIM	JJ
XWDWRWB	NNP
GRSTW	NN
ITQFR	VB
TTEWRR	VB
ITQFW	VB
IARX	VB
AWWIRT	NNT
MJBE	NNT
ZIMAN	NNP
NHNIT	VB
MJBX	NN
RIMH	NN
NDXSW	VB
ITQFH	VB
NPFWT	NN
MLXMWT	NN
SIKWII	NNT
GRSTH	NN
MTQBLWT	VB
MIKST	NNT
PI	NNT
ZQWQIM	VB
WEUR	NNP
MSPIQIM	JJ
HWFPEH	VB
LIBRIWM	NNP
ZEIR	JJ
MIIXSIM	VB
PSIKIAJRIIM	JJ
RGFWTIW	NN
GDLIM	NN
ERBWB	NNT
QJNIWT	NN
BWRMZI	JJ
SPIRH	NN
MIWTRIM	JJ
MRGLIM	NN
MINSWJIIM	JJ
EML	NNP
MQLJI	NNT
BWQRFJ	NNP
DRWFWT	JJ
MXWSPST	JJ
EMW	NN
EMQ	NNT
RGE	NN
RGF	NN
EMR	NNP
MIQDMH	NN
MWXFIIM	JJ
RGL	NN
SPIRT	NNT
QIZZH	VB
RCINIIM	JJ
AXIW	NN
HZIWTIW	NN
TEFIIH	NN
IMNH	VB
IMNI	JJ
KIRWRGIT	JJ
EITWNWT	NN
BWQR	NN
3	CD
LIMWDIH	NN
MWRIDH	VB
HTNPCW	VB
STIW	NN
TEFIIT	NNT
yyQUOT	yyQUOT
LQSIQWN	NN
FWPCW	VB
MWRXT	VB
XZW	VB
MWRXQ	NN
ELIWT	NN
GZIZWLIN	NNP
XZQ	JJ
PSNTRN	NN
ERWK	VB
BMQWM	IN
PRAIT	JJ
LBJL	VB
TQINH	NN
QWL	NN
LAWTT	VB
MFEWL	NN
NMWK	JJ
QWD	NN
MQBLIM	VB
LBJA	VB
RIALIIM	JJ
PIJR	NNP
MWAFMIM	VB
MTRGM	NNT
QWR	NN
QWQ	NNP
TQUM	NNP
AGMIM	NN
ILD	NN
150	CD
CWRT	NNT
QLIPRS	NNP
CWRP	VB
ILK	VB
PER	NN
PEL	VB
MWSQWWH	NNP
AJRQCIH	NN
MLAIM	JJ
CWRH	NN
ZKWIWT	NNT
CWRK	NN
7791	CD
FIWWQ	NN
MTIXWT	NN
BJIXWTIIM	JJ
LDBR	VB
MZHIRIM	VB
MSTIIM	VB
HSPIQ	VB
KAXD	MOD
HTNTQW	VB
QCT	MOD
HWRW	VB
MSTIIG	VB
EIDKNH	VB
LFNN	VB
TERIP	NN
AWFIWT	NNP
MCBIE	VB
KFLW	VB
MIAQWBSQI	NNP
HWRG	NN
PWNDMLISJIIM	JJ
ZIMN	VB
ZIMH	NN
AQHWIZ	NNP
LIL	NNT
HTREH	NN
NISIWNWT	NN
ITWMH	JJ
MWDIEIN	NN
MWDIEIM	VB
MXWZI	JJ
JRGI	JJ
HEZH	VB
PJRARQH	NNP
HFPLWT	NN
LIIBWBIC	NNP
ARWNW	NN
MFMETIT	JJ
TELH	VB
AWZNINW	NN
MFIBIM	VB
ANJIFMIWT	NN
GNQ	NNP
GNT	NNT
QNAIM	JJ
AFLIH	NN
AMSJRDM	NNP
GNB	NN
MJPXWT	NNT
AIN	VB
AII	NNP
MKR	NN
XZITWT	NNT
HGIWNIT	JJ
SLQCIH	NN
AIG	NNP
AIF	NN
MIWMN	JJ
AWPIR	NNP
NSPW	VB
ALTWR	NN
FMIKH	NN
MXFID	NN
AIWMIM	NN
NSE	VB
FWTPWT	NN
AIWMIW	NN
AWLIMPIT	JJ
IPGE	VB
MNSH	VB
BWXRI	NNT
MFWLM	NNP
MFWLL	JJT
IWRKBW	VB
ZLWJIQMN	NNP
AWPIW	NN
LIBRLIZCIH	NN
KIHNH	VB
DWDTN	NN
APLWLIT	NN
IIMCA	VB
HMWNIT	JJ
MXNH	NNT
MXNK	VB
AHWD	NNP
XLWMH	NN
MTIMJIWT	JJ
AWDISIAH	NNP
PNGAB	NNP
ASJWN	NNP
LFKWT	NN
NPLA	JJ
AWLPNI	NNT
SDR	NN
LFKWR	VB
RMTW	NN
NKPTH	VB
IDIETW	NN
LFKWX	VB
BHFWWAH	IN
NKXH	VB
SNSCIH	NN
NPGFIM	VB
NPLW	VB
NJWLI	JJT
CEQNIWT	JJ
MQWRH	NN
HTQPIT	JJ
HTGLMWTH	NN
LHGDIL	VB
AWPIIM	NN
IDWEIM	JJ
LEMWD	VB
MQLWT	NNT
GBETIIM	NNP
APLWT	JJ
MSIRH	NN
PWXDIM	VB
IABQW	VB
MSMRWT	NN
HTQBC	VB
TWBN	VB
PARQ	NN
HWZKRW	VB
RPWAIT	JJ
BRISJWL	NNP
MINIWT	JJ
LHGDIR	VB
RIGWFIM	NN
PNTH	VB
IRNDRH	NNP
MINISJRIWN	NN
MMFIT	JJ
BWLS	NNP
MWCP	VB
MWBFWBIC	NNP
AIBWD	NNT
BPWMBI	RB
BWLM	VB
XRWF	NNP
MWCE	VB
MFDRWT	VB
MWCG	VB
BWLE	VB
IRDNI	JJ
WLDZ	NNP
TKRIE	VB
XSRIM	VB
IGWWEW	VB
IHIRWTH	NN
MXIIKT	VB
PRWIQJ	NN
XLFH	JJ
TXRWT	NN
LALW	NNP
MSIRWT	VB
MEWRPL	JJ
EDIP	VB
QWLJIM	VB
EDIM	NN
AXRWNH	JJ
PDIWN	NN
2391	CD
LMSD	VB
MBIAH	VB
QJLNIT	JJ
NKWNH	JJ
QIWSQ	NN
NIJLW	VB
SJWDNJ	NN
DIRWG	NN
JRIIKMN	NNP
AWRIAH	NN
HTBRRW	VB
LCMCM	VB
RWXNIT	JJ
DIRWT	NN
NSIWNWT	NNT
MZGNI	NNT
HWXZR	VB
CWLET	VB
MWRICIT	JJ
BRWRIM	JJ
PIRWFM	NN
HPRIZW	VB
PITWX	NN
MPEILT	NNT
SMKWIWT	NN
PITWI	NN
NXFLWT	NN
IWWNIT	JJ
HNXITH	VB
TWEBR	VB
KMEJ	MOD
LQPX	VB
AIRWX	NNT
XIWNIIM	JJ
ZKWTW	NN
MNFR	NN
HCLIXH	VB
MDEI	NNT
TDHMH	NN
NACI	JJ
XWWIWTIH	NN
MDEN	NN
NACR	NNP
AKIPT	NNT
WWLBS	NNP
XLKAIM	NN
WWLBW	NNP
HCLIXW	VB
AIRWE	NN
ZKWTM	NN
KWXWT	NN
MXPIRH	JJ
XIIQIN	NNP
LIR	NNP
MJWSIM	NN
ARHB	NNP
KDWRIHM	NN
NFTDL	VB
8.51	CD
GNRL	NN
SPWNJNIWT	NN
LJQIH	NNP
TEWDT	NNT
MSWIMIM	JJ
KWNNWT	NN
NXTH	VB
GLIFH	NN
NXTM	VB
IWWN	NNP
ARCIWT	JJ
DWQR	NN
IBQR	VB
IFIBT	NNT
HERIM	VB
HWFLM	VB
HERIK	VB
MWBJXT	JJ
SBILH	JJ
AWJWNWMIIM	JJ
NWJRLH	VB
HPLILW	VB
TWJL	VB
KLWLWT	VB
NWJWT	VB
NFMWR	VB
MWSIQH	NN
MBIIM	VB
TGBWRT	NN
CIDW	NN
MMFLT	NNT
HGBLH	NN
TRGWL	NN
QCIN	NN
MIJTW	NN
NBXR	VB
NIFA	VB
BRAFWNH	RB
AMWCIWNLI	JJ
ITXIL	VB
SWCIALISJ	NN
RBEIM	NN
BGDWL	RB
MTBJA	VB
LIKWD	NN
QWHL	NNP
GWNZALS	NNP
HTPRSMW	VB
MWQSIN	NNP
ARWNWT	NNT
IQIMW	VB
HWJBEH	VB
QLINIT	JJ
MBJIXH	VB
IRIWT	NN
LHTNGD	VB
PTAWM	RB
TLBWFWT	NN
HTPRSMH	VB
NFBW	VB
CDIM	VB
601	CD
600	CD
PWELW	NN
PAWLI	NNP
PAWLH	NNP
WIRFWBSQI	NNP
BXIRWT	NN
PAWLW	NNP
NFBE	VB
LHTIIXS	VB
PWELI	NNT
BIQFH	VB
IRIIH	NN
MCLIX	VB
AINJRSIM	NN
MFAIWT	NN
AISWR	NNT
QRIAWT	NN
2891	CD
IARXW	VB
GIBWRH	NN
MWPLAWT	JJ
ABIJL	NNP
ALBLDS	NNP
LHGN	VB
FIRI	NNT
FIRH	NN
ZINWQI	NNT
MQNH	VB
AWPI	NN
AWPN	NN
WSJRIS	NNP
AWPQ	NNP
NNXL	VB
FIRT	VB
XIBWRW	NN
DNIS	NNP
LHGR	VB
WWRLD	NNP
MFWKLLT	JJ
BIJXWNW	NN
HWPIEW	VB
BIJXWNM	NN
DRWZIM	JJ
HWPIEH	VB
BIJXWNI	JJ
NPWCH	JJ
FISTH	VB
GIBWRT	NNT
ALIMLK	NNP
CRKI	NNT
CRKN	NN
MSGRTW	NN
IIRFMW	VB
SKWUM	NN
MHWLH	JJ
LHTAZR	VB
NEFTH	VB
MBZH	VB
JWL	NNP
GIJRH	NN
JWN	NN
PDRCIH	NN
MSGRTH	NN
JWB	JJ
EITWIH	NN
JWF	NN
PRFNWT	NN
MWCDQT	JJ
LHMIR	VB
MWEGLIM	JJ
MIWBAT	VB
XWRB	NNP
XWRG	JJ
NTWWKX	VB
LQWXWTIW	NN
AIWDIH	NNP
JRPIM	JJ
XWRP	NN
XTWMWT	VB
EIIRH	NN
FITWPH	NN
IFMFW	VB
LWWIINIM	NN
HPXDT	NNT
FMEWNWB	NNP
TPISTN	NN
NWGE	VB
HFRATH	NN
ADWNI	NN
IPHPIH	JJ
BHQDM	RB
EIIRT	NNT
TKWNWT	NN
LAWMIT	JJ
HTNCLWT	NN
LHTRPA	VB
ARWGNJIT	JJ
XWFFIM	VB
MKRIHM	NN
DANDI	NNP
HAWWRD	NNP
PWJBWL	NN
LHTRPQ	VB
SNIGWRIM	NN
LAWMIM	NN
MDWRG	VB
MWED	NN
ICIRWTIW	NN
DWLR	NN
LPTX	VB
IWSJWN	NNP
AIDIAWLWGIT	JJ
CPCPH	NN
LPTE	RB
IBWLW	NN
HGNWT	NN
ESQN	NN
MENIQWT	VB
FMFTH	NN
TANH	NN
QWALICIH	NN
PGRH	NN
HUH	NN
DIBRTI	VB
NRGFWT	JJ
TEFIINIM	NN
MINSWJH	NNP
TPEWL	NN
MGDIR	VB
ITNW	VB
SPRTI	JJ
NPFIT	JJ
SNDINISJI	JJ
HNHGTW	NN
MDGIF	VB
XLWPH	NN
FFIT	JJ
LAZN	VB
FFIM	CD
NITNW	VB
CIWN	NNP
HWEBR	VB
HTPREWT	NNT
CINIT	JJ
XWSLW	VB
IFRALIT	JJ
BIJWX	NN
NPGFTI	VB
LHTHWWT	VB
HKXIF	VB
MNFNGLDBAK	NNP
HDGIF	VB
BRWRH	JJ
GBINWT	NN
WWALAS	NNP
TQNIM	NN
TQCIBIM	NN
CHWB	NN
EBIRH	NN
EWBDTIT	JJ
MPWRFWT	RB
NTNW	VB
NTNH	VB
RWKFIM	VB
S.	NNP
A.S.	NNP
MWDRNIIM	JJ
EKW	NNP
PITRWNWT	NN
REF	NNT
LFBWT	VB
LQRB	VB
PDRL	NN
RCINIWT	JJ
FIMFW	VB
PWRT	NNP
LFBWR	VB
LFM	IN
ESQW	VB
EZIM	JJ
FWMRT	VB
LWWAI	NN
IMLA	VB
FWMRI	NNT
IDIDWT	NN
FWFNH	NNP
BHRBH	MOD
PWRE	VB
IIXWDI	JJ
HRSNI	JJ
TINWQ	NN
PWRJ	NNP
DWRFWT	VB
AIJIWT	NNT
ALWHI	NNT
MFQIPIM	NN
LHNIA	VB
LHNIB	VB
EWRKI	NNT
AIJLIH	NNP
EIWNIWT	JJ
MWFJT	VB
XWLFWT	NNT
RWDIAW	NNP
AWPRH	NN
DMIWN	NN
HFTTPWTW	NN
NJEH	VB
HWCIAW	VB
LHNIX	VB
FARLWJ	NNP
EWRKW	NN
ZKITI	VB
NJEN	VB
PIHM	NN
NIIDWT	NNT
XISLW	VB
RCINI	JJ
SR	NN
IITLWW	VB
SP	NNT
ERPAT	NNP
SK	NNT
MSMNIM	VB
SI	NNP
XZWIH	JJ
BIUX	NN
XILWPI	NNT
RCINW	VB
SL	NN
XISLH	VB
QUM	NN
ERERW	VB
SD	NN
MWCIAH	VB
PJRIARKLIT	JJ
MFWRIINT	JJ
CWPR	NN
FWMEIM	VB
MKWBDT	JJ
IBF	JJ
GWDLK	NN
NEWRI	NN
CWPH	VB
SPWNH	JJ
CWPN	VB
GWDLN	NN
MRXIQIM	VB
MILWIH	NN
AFDWDI	JJ
5357	CD
LHTLBF	VB
PGE	VB
RIALI	JJ
MWRD	NNT
DIIWID	NNP
ASIH	NNP
INCX	VB
MRSI	NNP
PELW	VB
IFNH	JJ
MLAKH	NN
DIN	NN
MLAKT	NNT
PGW	NNP
MRSR	NNP
AIPWA	RB
PGR	NNP
PELH	VB
XLWCIM	NN
LFLM	VB
LFLB	VB
MLPNI	IN
MWRH	NN
PWAMH	NN
EBWTH	JJ
MCXIQN	NN
MCXIQH	JJ
MNIETH	NN
AFDWD	NNP
PIRWFIM	NN
TWCAH	NN
XSKWNWT	NN
QIPAWN	NN
HWLKWT	VB
EWFIM	VB
RWFM	NN
MCLIXIN	VB
EMLWTIHN	NN
QJIN	NN
HTNSH	VB
MSTMK	VB
FIA	NN
AWMRWT	VB
EDIPWT	NN
MSTMA	NN
LERER	VB
RWMN	NN
RWML	NNP
MIM	NN
MIL	NN
HPNIITM	NN
IXLIP	VB
EIDN	NNP
MIC	NN
RCIM	VB
MWZRIM	JJ
MID	RB
RWMA	NNP
AWWIRH	NN
IFNW	VB
MXWIIBIM	JJ
PIIBWRIJ	JJ
RCIP	NN
BHMFK	IN
RWMW	NN
TWFBIM	NN
IXLIJ	VB
MCWQWT	NNT
PWLNI	JJ
NMFKW	VB
MFWLMT	VB
LCIIT	VB
NMFKT	VB
LXSWK	VB
HCBEH	NN
QILLW	VB
HTGMD	VB
PRNSTW	NN
MPTXWT	NNT
MLMDT	VB
MNQH	VB
PRNSTM	NN
MBWQFWT	JJ
LCIID	VB
KINWS	NNT
NQJ	VB
HPRIE	VB
NQI	JJ
LCIIN	VB
NQM	NN
MEWGNT	VB
JWRDT	VB
MLAI	NN
FINIIM	NN
NRAWT	VB
NWCXNW	VB
HTIIXSNW	VB
INWEW	VB
FMWNT	CDT
LHTNXM	VB
IWRDWT	VB
HFNH	RB
SNJIANH	NNP
TWBET	NN
RIQWD	NN
NPJR	VB
QIIM	JJ
FMWNH	CD
XGBI	NNP
MMIJ	VB
KSP	NN
SJNDRDIIM	JJ
PAPA	NN
FITPW	VB
ZKWKIT	NN
RWWXTM	NN
HWDEWT	NN
QRIST	NNT
BAMT	RB
MESIQIM	NN
HTBQF	VB
ICIAWT	NN
GWIIM	NN
FLILIIM	JJ
HWZHRW	VB
MWEJ	JJ
7	CD
NPJRH	VB
HZDHITI	VB
LMDNIM	NN
HKRNW	VB
XTWM	JJ
XTWL	NN
RWWXIM	NN
CIWD	NN
BWRXS	NNP
AISLAMIWT	JJ
ERKTI	VB
FIBWFIM	NN
JISH	NN
MZWWDWT	NN
XFIBWT	NN
MPLIA	VB
CIWR	NN
CIWW	VB
BIHMUF	NN
XLWPIIM	JJ
BIZBWZ	NN
NZHRIM	VB
MWJIWWACIH	NN
MCIINT	VB
FGIAWT	NN
HIRANW	NNP
LHPXIT	VB
MLMDIM	VB
IEIL	JJ
MSGDI	NNT
MZKIRIM	VB
MARGRJ	NNP
2371	CD
HCBTW	NN
LNQH	NNP
SDAM	NNP
GRMNIWT	JJ
PSIKIT	JJ
MLAH	JJ
HFEIIT	NNT
MLXMTIWT	JJ
MLAW	VB
LIJWL	VB
BSISIHM	NN
XINWK	NN
MLKWTI	JJ
GWRDN	NNP
HTRFM	VB
PLDMN	NNP
TXNH	NN
XUL	NNP
ITIIXS	VB
TQRH	NN
TXNT	NNT
MJBXI	NNT
MLKWTW	NN
NFIAWT	NN
QLIPWRNIH	NNP
TSPR	VB
TSPQ	VB
HTIIXS	VB
MXZH	NN
IFQWL	VB
MBJIXIM	VB
HWKFR	VB
ISPQ	VB
WWITWR	NN
MXPFT	VB
LDWWX	VB
BRWMPILD	NNP
5102	CD
HTNGDWT	NN
ARNS	NNP
MRWFLT	JJ
MDRKH	NN
RIAQCIH	NN
LHTPLSP	VB
MTMFKT	JJ
PRSPQJIWWH	NN
SPRWTIT	JJ
MWEMDWTW	NN
HWQWS	NN
IWCGTI	VB
TRWMTI	NN
FKRM	NN
MFRTT	NN
TRWMTM	NN
TRWMTN	NN
IWQR	NN
GLIDH	NN
AQCIH	NN
RAWIH	VB
IBWA	NN
DQDQNWT	NN
AIGWR	NNP
FAJI	NNP
WWRWNIN	NNP
IWQM	VB
SINI	NNP
FKRW	NN
SING	NNP
IBWL	NN
NIQWLH	NNP
TRWMTW	NN
RWJFILD	NNP
BIALIQ	NNP
LHIMFK	VB
MFRDIH	NN
MPEILH	VB
JWPIQ	NNP
HRCAWT	NN
MFRDIM	NN
HWENQW	VB
ECMAWTH	NN
354	CD
ECMAWTN	NN
PILSWDSQI	NNP
ECMAWTM	NN
HSTGR	VB
MEFI	NNT
MCJRPIM	VB
HGEH	NN
ZWGWT	NN
HEBRH	NN
NMWKWT	JJ
LMFK	IN
WIKWX	NN
LMRWT	IN
HEBRT	NNT
HGET	NNT
85.2	CD
NZHR	VB
IAMR	VB
PIGRW	VB
RKZIM	NN
XZRTI	VB
IEL	NNP
LHTXRWT	VB
LHTNER	VB
MNHIGI	NNT
IPJRL	VB
HPRJH	NN
ICJRKW	VB
NAMNWT	NN
MTKWWNIM	VB
HSKMIM	NN
AIGWD	NN
IWNPQW	VB
NFLX	VB
FWXXW	VB
HTABD	VB
PICWI	NN
MHLKW	NN
MTMWDD	VB
MHLKM	NN
IWKLW	VB
CPWIWT	VB
NGDI	JJ
QLIJTM	NN
ALGNJIWT	NN
BIIQR	NNP
QWLIN	NNP
HWBQEW	VB
PTXNW	VB
NNQJW	VB
NWLD	VB
RNJGN	NN
QLJWT	NNT
IRWN	NNP
5107	CD
WWIZWALIIM	JJ
IRWQ	JJ
XNGH	NN
HDXT	NNT
SBIBTN	NN
BDWMH	IN
HTXIH	NNP
MPTH	JJ
LAWMIWT	JJ
HTXIL	VB
AWRN	NN
MSTMNT	VB
AWRM	NN
NPJ	NN
AWRK	NNT
AWRH	NNP
AWRI	NNP
ANJI	MOD
MQLE	NN
NPALI	NN
HTKWWNTI	VB
LHDLIP	VB
ANJIRISJ	NNP
MAKZB	JJ
AWRX	NN
MDHIMH	JJ
HANS	NNP
FMXWT	NN
FITQ	VB
QMIJIM	JJ
QJBIM	NN
ERKIM	NN
FLILIT	JJ
LAKWP	VB
CMCWM	NN
MSWBK	JJ
MAPIINIM	NN
NERKIM	VB
ZAB	NN
LIMWDI	NNT
LAKWL	VB
PLQJIM	NN
ZAT	PRP
LHXLIP	VB
MXDLIM	NN
NICXWNWT	NN
ABDNW	NN
NRTEIM	VB
LHGBIR	VB
MMSDIM	NN
LNIHN	NNP
QBLT	NNT
QBLW	NNP
QBLH	NN
QBLN	NN
FWPRH	VB
HWKW	VB
LHAMIN	VB
TCWGH	NN
XWLP	VB
NDXTH	VB
NWJIM	VB
HWKX	VB
MBXN	NNT
PJRIWJI	JJ
XWLF	VB
HMZHUT	NNP
NWZLIM	NN
ARWKWT	JJ
NZQQIM	VB
HWKN	VB
XWLM	VB
XWLI	NNT
XWLH	NNT
NWER	NN
AITIXAD	NNP
LHGBIH	VB
REIWNWT	NN
NWEZ	JJ
MSAIT	JJ
FBWEIIM	NN
EINIIM	NN
AICJDIWN	NN
ZIKRWNWTIW	NN
MWBXRWT	JJ
NWED	VB
RWDPIM	VB
BRMN	NNP
RBWTA	NN
MXBRT	VB
TGWBH	NN
NWEM	NN
NELMH	VB
DIQSJRH	NNP
NITNIM	VB
NFMH	NN
HNRI	NNP
SRJIM	NN
MRWTW	NN
AWKLI	NNT
NELMW	VB
NELMT	JJ
MTIICBT	VB
IWPIE	VB
GWG	NNP
GWF	NNT
GRIPIN	NNP
MASIWWI	JJ
GWN	NNP
NMNET	JJ
NMNEW	VB
FANNWT	NN
NMNEH	VB
DWNM	NN
GWP	NN
NHIGTN	NN
HDGMTI	VB
TMH	VB
PWELWT	VB
AJWMIM	JJ
MXPF	VB
5.6.67	CD
HWN	NN
JWBT	NNT
FDRWT	NNT
DBRI	NNT
EQRWN	NNT
ASIRI	NNT
NSIK	NNT
HWD	NNT
NJH	VB
MDIWM	NN
NSIM	NNP
NJW	MOD
TPWXIM	JJ
LPSWQ	VB
NFRPH	VB
EQRWT	NNT
0007	CD
MNWXT	NNT
0003	CD
XBRWT	NN
LWXIWT	NNT
TERIPIM	NN
SIKWMW	NN
N	NNP
IIQRH	VB
HBJIX	VB
HXMCWT	NN
280	CD
RWD	NNP
HTIIXST	VB
MWCAH	NN
GRGRIM	NN
LAXD	NNP
QJGWRIWT	NNT
LAXR	IN
BSIS	NN
HTQIIMW	VB
RWI	NNP
QBILH	JJ
TKNIWT	NNT
XFF	NN
EIR	NN
RCX	NN
NXT	NN
ARWASJI	NNP
NRMSH	VB
RCW	VB
HTBJAWIWTIH	NN
IWWTRW	VB
PAWSJ	NNP
QWRDRWI	NNP
RCH	VB
TQFWRT	NN
ZWNWT	NN
MEMIDH	VB
EIN	NN
PQWLJH	NN
HFTKNEH	VB
IIAPFRW	VB
TRGWMW	NN
FIDWRI	NNT
FAR	NN
NXRT	NNT
FXQNIM	NN
FXQNIH	NN
PTWXIM	JJ
TIAWR	NN
BXWR	NN
FXQNIT	NN
FBWE	NN
MFWEFET	JJ
FAL	VB
BQNAAR	NNP
FAB	VB
RWT	NNP
NLMD	VB
MXBL	VB
XWSIINI	NNP
KIPWRIM	NN
XQLAIIM	JJ
MTBHRIM	VB
PLAJINI	NNP
MINISJRIALI	JJ
SBWR	VB
BWLJIM	JJ
003	CD
002	CD
001	CD
HTBCE	VB
007	CD
006	CD
005	CD
004	CD
008	CD
TXBWLH	NN
RWEI	NNT
PRSPQS	NNP
PINI	NNP
MFDR	VB
NMSR	VB
MIDH	NN
TIPWL	VB
BIWB	NN
MIDE	NN
LKLWT	VB
SWWILIH	NNP
KINTH	VB
MFPIE	VB
MCIIRIM	VB
LKLWK	NN
MAMN	NN
WEDWT	NNT
LKLWL	VB
LBNH	NN
MFPIL	JJ
LHSTIR	VB
MFTXRR	VB
PINT	NNT
AIFRH	VB
MAPFRT	VB
FWKNE	VB
CCW	VB
761	CD
LHCHIR	VB
SPWRJIBI	JJ
BWQARFJ	NNP
FWKNT	VB
AIFRR	VB
REIWNWTIW	NN
EMIDIM	VB
RWAIM	VB
PIH	NN
REIWNWTIH	NN
XRPTM	NN
MRQM	NN
PIL	NN
FLIX	NN
FEWT	NN
SMKWT	NN
TWKNIWTIW	NN
MTWSKL	JJ
NXH	VB
EIBWD	NN
HFTME	VB
HFTMF	VB
CIIDIM	NN
WWIZH	NNP
ABIGDWR	NNP
FEWN	NNT
FNTIIM	NN
PIW	NN
KEBWR	IN
DILMH	NN
PI.	NNP
FIEMWM	NN
IXTWM	VB
FWXJ	NNP
TPILH	NN
IEBIRW	VB
TPILT	NNT
FWXR	NNT
ZIID	NNP
IRXIBW	VB
HWLKIM	VB
FWXX	VB
FQRIWT	JJ
ZIIN	NNP
HZDHWT	NN
AWWRJWN	NNP
SKWMI	NNT
MAIR	NNP
IELIL	VB
KRGIL	RB
15.459.00	CD
LFXZR	VB
61	CD
GBWH	JJ
QDWFTW	NN
ARWJI	JJ
MGNIM	VB
ABWTIW	NN
GRWF	NN
MINHL	NN
IBJA	VB
GRWE	JJ
GJW	NN
MWX	NN
XRWC	JJ
XRWB	NN
MBWGRT	JJ
GRWS	NNP
HTIIFBWT	NN
DGLW	VB
XICWNI	JJ
MWJ	NNT
RWSI	JJ
BWRRWT	NN
MWL	IN
QWRAWT	VB
NWP	NN
HTIIMRW	VB
MRCDS	NNP
AMN	NN
AMA	NN
NWX	JJ
AMF	RB
TTEQF	VB
JLWWIZIH	NN
WIIJ	NNP
EIRAQI	JJ
NWN	NNP
AMR	VB
AMT	NN
AMW	NN
LDRWF	VB
RBT	JJT
ALJRNJIWWIIM	JJ
DWBRWBICQI	NNP
DWRWT	NN
XIPWFIM	NN
WIIN	NNP
MTBSS	VB
DWRWN	NNP
GRACIH	NNP
HFTXRRH	VB
HSRJWT	NN
HTQPI	JJ
AMINWTM	NN
14.46	CD
IZMIM	NN
PWRMLI	JJ
QWMDI	NNP
76	CD
MMWCE	NN
IIFWB	NN
TBEW	VB
GZRI	NNT
TBEH	VB
REWLI	NNT
BIJAWN	NN
HZDHW	VB
LXQWT	VB
TXZIQ	VB
HFPIE	VB
ZILWNI	NNP
XIPWF	NN
KBDI	JJT
KBDH	JJ
QTWLIM	NN
ZABIM	NN
XWFBIM	VB
HNET	NNT
AXRIWTW	NN
EMDTW	NN
BXRIIN	NNP
NISWI	NN
WRIACIH	NN
SJRIAWJIPIT	JJ
SWMKIM	VB
BIWKIMI	JJ
WWRIIRS	NNP
NISWX	NNT
MFPXTIT	JJ
HXLJWTIW	NN
AIMTH	VB
RFAIT	VB
MEMD	NN
XCIIT	NNT
SWLJN	NNP
MNWI	NN
THIINH	VB
HAJH	NN
AWPNTI	JJ
MNWS	NN
SIMPJWM	NN
IRWFH	NN
NRAIT	VB
MNWX	JJ
HTPREW	VB
FFINSQI	NNP
ABIMWR	NNP
TAWCH	NN
EPIP	NNP
MWNGWLI	JJ
LGM	VB
LIBRALIM	JJ
MPTIEH	JJ
MENIINT	VB
MAWXDIM	VB
RFIMWT	NNT
GDWLWT	JJ
QIWWI	NN
QIWWH	VB
MXJIA	VB
HTMWDD	VB
JARSWB	NNP
WL	ZVL
ICQH	VB
HXLIJ	VB
HWCBW	VB
HWBSH	VB
MXJIM	NN
QBWE	JJ
HPRT	NNT
LKPWT	VB
HXLIP	VB
HXLIQ	VB
HZMNTW	NN
HWLQWMB	NNP
HPRF	NN
EWNWT	NN
4691	CD
NWTRIM	VB
HWKNSW	VB
ZIKRWN	NN
IIZWM	NNT
TW	NNT
TT	MOD
HICQWQ	NNP
GWMI	NN
A.	NNP
TL	NNT
TM	JJ
NWSDH	VB
MWRKBIM	JJ
MTQIIMT	VB
MAMNIM	NN
MWSP	NNT
NICWC	NNT
MWBLJT	VB
HWLIDW	VB
AB	NN
QRQWB	NNP
AD	NNP
LJINW	JJ
AI	MOD
AK	CC
MDINTW	NN
AM	IN
AL	IN
ICIBH	JJ
AN	NNP
NKLLW	VB
AS	NNP
AT	AT
SPWGIWT	NN
ISRB	VB
MPRGNIM	VB
AZ	RB
AIMAM	NN
EMITIW	NN
MTMCAT	VB
DIWWXW	VB
KRWKH	VB
QWDMTH	NN
IRIBWT	NN
EICWMIM	NN
HTNXM	VB
CHRIIM	NN
9691	CD
AKZBH	NN
MSIRT	NNT
TBIETM	NN
FALW	VB
TBIETH	NN
FALT	NNT
TIAWRI	NNT
FALH	NN
MXWDD	JJ
ALQJRWNIT	JJ
LAWMNIWT	JJ
IKWL	VB
IWSI	NNP
XTK	NN
LHSTWBB	VB
IWSP	NNP
yyCLN	yyCLN
IWSR	VB
MHWT	NNT
TAWR	NN
THIWTIW	NN
MIRWMIT	NNP
NERIM	NN
JQSJIM	NN
MAMRK	NN
KBDWT	JJT
1791	CD
APRN	NNP
TGEW	VB
XWMIM	JJ
LBWFWT	VB
BECM	RB
QIC	NN
KIPWT	NN
PRICWT	NN
NFLL	VB
GIBWFN	NN
LGRWR	VB
MIKAIL	NNP
709	CD
AZKRWT	NN
LHWDWT	VB
IMLAW	VB
ARNHM	NNP
NEDRWT	VB
LGRWM	VB
HRXBH	NN
LWJWN	NNP
ZWEMIM	JJ
6591	CD
MWCHR	JJ
RAIWNWT	NN
CWWXWT	NN
LFMR	VB
HQCIBH	VB
MCXH	NN
GILRDI	NNP
BLTI	MOD
FZWRIM	VB
EWMRI	NNP
CDUL	NNP
HMLCTW	NN
RIWZI	NNP
MWELIT	VB
HTNQFWIWT	NN
LTPWF	VB
QLASIT	JJ
TEMWLH	NN
MGBLWT	NN
PLAJ	NNP
EWL	NNT
PTWX	JJ
MFTLM	VB
GFMIM	NN
PLIMWT	NNP
DIRBNH	VB
KLBIM	NN
LWQX	VB
KIWWN	IN
MQRR	JJ
ITBSS	VB
EMIAL	NNP
LWQS	NN
LWQH	NN
MQRA	NNT
AWLM	CC
MICGIM	NN
AWLI	RB
LAWMI	JJ
DMWQRJI	JJ
MWTNIT	VB
SRJN	NN
SRJI	NNT
SRJW	NN
LBSS	VB
MBNIM	NN
MISJR	NN
LXWQR	VB
P	NNP
DXWPH	JJ
TIKWNIT	JJ
IWCEW	VB
HGFTI	VB
TIMNXIH	NN
RWFMIM	VB
DWKNIAN	NNP
LSPR	VB
LSPQ	VB
HMLICH	VB
EWINWT	NN
DWMINNJIT	JJ
XWTMW	NN
TQWPTH	NN
XWTMT	NNT
AINPLCIH	NN
MTNHL	VB
HWFMJH	VB
TRGWLWT	NN
BAS	NN
HCMDT	NNT
MFNIIM	JJ
LILIAN	NNP
DWXUWT	NN
ASPH	NN
IIFARW	VB
ASPW	VB
BSISH	NN
ASPR	VB
FIRWTW	NN
HCMDH	NN
TISGR	VB
NWCX	VB
BKWRH	NN
FLIFI	JJ
HGDRH	NN
MTIIXS	VB
NWCR	VB
EBRW	VB
MTWSKLIM	JJ
EBRI	NNP
EBRH	VB
NWCL	VB
24.90	CD
MWKRT	JJ
HGDRT	NNT
WAFINGJWN	NNP
AIKWIWT	NN
EFWIIM	VB
MWCEWT	VB
AINJR	NNP
IHNH	VB
NWCRIIM	JJ
PCWE	JJ
MARH	NNP
FWNWT	JJ
XFBNW	VB
MARQ	NNP
MEWLIM	JJ
NISN	NNP
JWJNHAM	NNP
LDET	VB
MPQX	NN
TFEH	CD
AIPSWWIC	NNP
XLWMWTIW	NN
IWQCW	VB
GRPIJI	NN
MPELI	NNT
KWTNH	NN
RAGIB	NNP
NAMR	VB
PLFTINAIT	JJ
AQZISJNCIALISJI	JJ
IAN	NNP
PLFTINAIM	NN
TIKNNW	VB
AIBRIM	NN
HLWWIITW	NN
MPQD	NNT
MFRTIM	VB
ASIPT	NNT
NHG	VB
MWKRXIM	VB
MIICBT	VB
KWTBT	VB
FJIPT	NNT
MWZRH	JJ
BNQAIT	JJ
NHI	NN
RIBWIN	NN
QNAH	NN
HIA	PRP
NCWLT	NN
DWDH	NN
SJIB	NNP
NHR	NNT
HIH	AUX
SJIM	NN
EQRIM	JJ
ASIPH	NN
BWHDNH	NNP
EQBIM	NN
TISKWL	NN
AZNIHM	NN
METIR	VB
MEWNIINWT	VB
ARIZH	NN
AXRAI	JJ
ZHWTM	NN
HMFIK	VB
IPRCW	VB
SMLIT	JJ
ASWNWT	NN
AQDMAIM	NN
MILWAIM	NN
MGDL	NN
GZIM	NN
GZIN	NNP
QIIMIM	JJ
HRMT	NNT
TPWS	VB
FIBFH	VB
ITQIIM	VB
MSPR	DT
PIGWEIM	NN
EWINT	JJ
MGIEH	VB
5,000	CD
HTIICB	VB
MGDT	NNT
CNIEWT	NN
HXWDF	RB
XSRI	NNT
KBIKWL	MOD
BRKIH	NN
HENIQH	VB
LERWK	VB
BRBWR	NN
NAILH	NNP
HENIQW	VB
HWZMN	VB
XSRT	JJT
XSRW	VB
PGMIM	NN
HFKLH	NN
RAF	NNT
ALUM	NN
EQWBH	JJ
AWMLLIM	JJ
LBW	NN
MIIECT	JJ
NTN	VB
SWERT	JJ
RAH	VB
XTNIM	NN
RAW	VB
NPJLIN	NN
LBD	RB
SMIM	NN
LBF	VB
LBH	NN
LBK	NN
ATRI	NNT
LBM	NN
FGB	NNP
MQWISJ	NNP
FALWT	NN
TQCIBIWT	JJ
MQDFT	VB
BFL	IN
ISIIEW	VB
BFR	NNT
IIXTM	VB
NINWXIM	JJ
MNDIM	VB
BIIRWT	NNP
022	CD
HTNPLWT	NNT
ZHWIWT	NN
HWRJWN	NNP
TMIHH	NN
BIQR	VB
SNAJWR	NN
EIBWRW	NN
MNCSJR	NNP
SDNH	NN
IWGIN	NNP
MFJR	NN
QJMANDW	NNP
LHIRAWT	VB
BIQF	VB
MJENIM	NN
MRQMI	NNT
SDNT	NNT
IKINW	VB
IFRJJ	VB
IMFIK	VB
GRWNDMN	NNP
IFW	NNP
NFARW	VB
IFR	RB
MGMGM	JJ
TEFH	VB
701	CD
IFE	NN
TPWQTW	NN
IFB	VB
AIFTI	NN
IFN	JJ
MPLGTI	JJ
FRDW	VB
HKRXIWT	NN
TKWNH	NN
CED	NN
MPLGTW	NN
LHCEID	VB
IIRDW	VB
141	CD
AWPPT	VB
EWMDWT	VB
LLKLK	VB
XLWQI	NNT
CER	NN
CEQ	VB
STM	MOD
NPSDWT	JJ
MPLGWT	NN
CADQ	NNP
RWWQIM	NN
QAMRI	JJ
AXWZ	NN
HWFLKH	VB
SBTI	NN
MIBNH	NN
52.05	CD
HWFLKW	VB
LGWNN	VB
MTWARIM	VB
PWLIJIIM	JJ
MXDLIH	NN
WNQAJRMAN	NNP
PWQDWT	VB
ARWK	JJ
MFMETI	JJ
KFLWNN	NN
ARWN	NN
HFIGW	VB
HEDT	ZVL
AHBWT	NNT
BIQWRTIT	JJ
HEDR	NNT
SJRAWS	NNP
HKLLT	NNT
RBIN	NNP
RBIM	JJ
HFIGH	VB
RBIC	NNP
RBIB	NNP
LXSWM	VB
DQIQWT	JJ
HAFIMW	VB
FIINR	NNP
MUR	NN
IWFLMW	VB
RWQX	NN
HXFDH	NN
NHWG	VB
GWLDING	NNP
BRIWN	NN
MWWTR	VB
QDMNI	NNP
HFBT	RB
FWBL	NNP
KDWRGLNIM	NN
HIBJ	NN
ASR	VB
PNIITH	NN
PNIITI	NN
APFRWT	NN
CRPTIM	NN
QBEH	VB
NUL	JJ
SAWTHMPJWN	NNP
EFRWT	CDT
HPRIIT	NNT
ASD	NNP
FWBW	NN
ASI	NNP
PNIITW	NN
LHIGBWT	VB
NZIRWT	NN
LJFJF	VB
QCRH	JJ
CRIKIM	VB
MSWIMT	JJ
HRFETM	NN
R	NN
IEZBW	VB
JMBWR	NNP
FWLLIM	NN
DUR	NN
GSI	NNP
ARGWNIT	JJ
MBWDD	JJ
APWDI	NNT
GRNDIWZIWT	JJ
XBRH	NN
MXDF	RB
AXDIM	JJ
XBRK	NN
PRWE	JJ
JIPWS	NN
NPFM	NN
NPFH	NN
NPFI	JJ
IEMWD	VB
RICRD	NNP
BLWMH	NNP
BRIHUM	NNP
QBWCWT	NN
HZHIRH	VB
KBFH	VB
IMWQM	VB
GINWI	NN
CRKNWT	NN
RAINW	VB
MZWINT	JJ
MXLIM	VB
MRBK	NNP
2.2	CD
TFIEIT	JJ
BAIM	VB
BAIN	IN
LHERIK	VB
QRIIRISJIT	JJ
SBLNI	JJ
HWPET	NNT
IIAMR	VB
HBNTI	VB
KWR	NN
AWLIMPIADT	NNT
KWX	NN
ZANW	NNP
TWKNN	VB
KWWNWTIW	NN
TWKNH	NN
ZANR	NN
QFIF	NN
MEKB	VB
0001	CD
KIMIQLIM	NN
HDXWT	NNT
MWFBI	NNT
QFIM	JJ
BHEDR	IN
AILCW	VB
QFII	NNT
KTBWT	NN
EWBIW	NN
TIBH	NN
FIQAGW	NNP
ASPIRIN	NNP
MCMCMT	VB
HFTLJWTH	NN
BEIQR	MOD
XWLQ	VB
TFWRH	NN
LHBIE	VB
DIEH	NN
MBRQ	NN
NCBRW	VB
TFWRT	NNT
IDBRW	VB
MWSIQLIT	JJ
4,509	CD
TXSR	VB
MPLTW	NN
SNGWRIWT	NN
MPLIAH	JJ
ECWR	JJ
ECWM	JJ
XIFWBI	NNT
GIMWR	NN
QRIINR	NNP
TIALC	VB
IICA	VB
GBIEI	NNT
XIZBALLH	NNP
ECWB	JJ
IENH	NN
HSBRIM	NN
RAWWTNIT	JJ
KRISJI	NNP
KRISJH	NNP
DWIDI	NNP
MWSJ	NNP
ADWJ	NNP
MBXR	NN
LPIIS	VB
MASIWWIT	JJ
LIN	NNP
EWLWT	VB
RWSIM	NN
ADMH	NN
RWSIH	NNP
MWSA	NNP
FMALNIIM	JJ
EMLT	NNT
TPIST	NNT
120	CD
ELWTW	NN
AXRWNWT	JJ
MKRSMIM	VB
126	CD
CMXIM	NN
ADMT	NNT
ABLM	NN
RWSIT	JJ
KIRSMW	VB
AZHRH	NN
KLLIWT	JJ
JRWRISJI	JJ
AIMCH	VB
TNAIH	NN
TNAIM	NN
GWLMI	JJ
ICWIN	VB
LIP	NNP
AIMCW	VB
MRWWIXWT	VB
SIRB	VB
MMWMNT	VB
TGWBT	NNT
XLPH	VB
QIDMW	VB
MSPRWT	VB
HWBILH	VB
AIWN	NNP
AIWM	NN
MMLA	NNT
DEWT	NN
TIERK	VB
LFXQ	VB
AQDMIT	JJ
MKWWNT	JJ
LXZQ	VB
MXZIQI	NNT
MXZIQH	VB
KDWMH	RB
PWGI	NNP
PSQH	NN
DINMIJ	NN
HERCH	NN
PGEH	VB
TWPX	NNP
PGEW	VB
TWPC	VB
MWDRNIZCIH	NN
AMCEI	NNT
DGMI	NNT
MWSR	VB
XFWBWT	VB
MTKNTIM	NN
PISGH	NN
IBFIM	JJ
IAIR	NNP
NFAL	VB
MDIDH	NN
MIWTMIM	RB
BAXRWNH	RB
MTIIXSIM	VB
HWRIH	NN
ATIQH	NN
HWRIM	NN
HWRIF	VB
AMRIQAIM	NN
FWIICR	NNP
MJWSI	NNT
HZKIRH	VB
MEWRBT	JJ
SWDIWT	JJ
ELIAWP	NNP
MFKNET	JJ
MKFPWT	NN
ERBII	NNT
ERBIT	JJ
BWDQIM	VB
ZWEP	VB
NQIWN	NN
AMRIQAIT	JJ
QDWMWT	JJ
GLAWQWMH	NN
IXIDWT	NNT
LHFLIK	VB
LHFLIJ	VB
HRGIFH	VB
LRPA	VB
HEIRH	VB
RHIJWT	NN
3,100	CD
SLIDH	NN
IQWDMW	VB
AWRTWDWQSIT	JJ
QDNCIH	NN
ALIBI	NN
ZIKRWNWT	NN
JRXW	VB
AGAJ	NNP
MXWQQIM	NN
ALMGWR	NNP
HEFRH	NN
XQIRH	NN
IKTWB	VB
TIRAH	VB
AWRTWDWQSIH	NN
SIRWBW	NN
LRKWB	VB
AWNW	NN
LRKWF	VB
BKIRIM	JJ
HFLKWTIH	NN
NIRNBRG	NNP
IARMQWB	NNP
ANG	NNP
HFLKWTIW	NN
MTNGFWT	VB
FIXH	NN
SIRWBM	NN
31.3.90	CD
RAFM	NN
QPSPQW	ZVL
MDINH	NN
RAFI	NNT
AWJWQRJ	NN
LBQF	VB
BRADPWRD	NNP
BILH	VB
GQSWN	NNP
MWLWQWLWT	NN
RAFIWT	JJ
MTBQFIM	VB
MSTWDD	VB
ALIWJ	NNP
LBQR	VB
BXINTW	NN
AWLMRJ	NNP
TKIN	VB
NRXB	JJ
NWRAH	JJ
AIFIM	NN
AIFTW	NN
DIWWXIM	NN
AIFIT	JJ
BXINTM	NN
SIMNW	VB
GRIMT	NNT
NIDAL	NNP
MRGWE	NN
QWPT	NNT
HBJXTW	NN
AWSIFQIN	NNP
FRIWN	NN
MGDLIM	NN
HWGH	NN
TINWQWT	NN
HWGN	JJ
NAKLIM	VB
LAFWRM	RB
QWPH	NN
QJNIM	JJ
QWPL	NNP
MFJRTIIM	JJ
ARCIT	JJ
IEWRRW	VB
HPQIDW	VB
AIJIIM	JJ
RWPPT	JJ
PJRIWJIWT	NN
BRIT	NN
MBKRIM	VB
MARGNT	VB
QWLNWE	NN
DRWF	VB
PWLMN	NNP
MWKTR	VB
NZIPH	NN
EMIDWTW	NN
MNGNWNI	NNT
EFWIWT	VB
MXZIR	VB
ABINTN	NNP
MMWSDT	JJ
DIRQJWRIM	NN
BPNI	IN
NWAM	NN
LIIB	NNP
MNXH	NN
PQISJAN	NNP
MWSGR	JJ
KDWR	NN
BD	NN
BF	NNP
49.80	CD
BA	VB
KWTLI	NNT
BL	RB
BN	NNT
BI	NNP
BK	NNP
BT	NNT
MRQDW	NNP
JPXWT	NNP
IBWJL	VB
BQ	NNP
BR	NNP
EIRAQIIM	JJ
MRAIIN	VB
HFKBTI	VB
HBEWTIHN	NN
NMNIM	VB
LCRP	VB
DIRH	NN
LPRJ	VB
RWJACIH	NN
7,000	CD
QIWWITI	VB
CIWWTH	VB
INCIX	VB
GWB	NNP
MSLWLIM	NN
HKI	RB
MXWIBWT	NN
HKL	NN
IGDL	VB
NMNIT	VB
DMWGRPIT	JJ
LTRWM	VB
NSMK	VB
SKSWKI	NNT
HTQRB	VB
AIXWI	NNT
AIXWL	NN
FILWB	NN
HTNGFH	VB
NQWDWT	NN
AIXWD	NNT
FILWJ	NN
261	CD
AIXWR	NN
RJWRIQH	NN
HFQPWT	NN
JIWLI	NNT
MSRH	VB
LATR	VB
EKBRIM	NN
SQR	NNT
HWRGL	VB
MSRB	VB
ALIMWTM	NN
QIWWTH	VB
ETIDI	JJ
SQI	NNP
LHRWG	VB
HRKB	NN
AWKSPWRD	NNP
MAXDIM	VB
XIWNIT	JJ
DIWN	NN
MTAM	NNT
AWRGN	VB
TAGID	NN
ZEMW	NN
987	CD
DWWX	VB
MFHW	NN
JWR	NN
RWPAI	NNT
IQBLW	VB
KAL	IN
DIWQ	NN
DIWR	NN
HMCATW	NN
TMK	VB
ALWN	NN
HGIEH	VB
EMWDI	NNT
IFBW	VB
MQBLI	NNT
KTMIM	NN
GBWHI	NNT
GBWHH	JJ
AQDXW	NN
MDWIQIM	JJ
LLA	IN
DLIIM	NN
SEIPIM	NN
BMPWRF	RB
BIBIM	NN
ASISJIM	NN
MJLJL	VB
FIDRH	VB
BDI	NNT
HZNXH	NN
BDQ	VB
SQIRH	NN
LIAWR	NNP
ERIMWT	NNT
045	CD
MLWWH	VB
NJF	VB
LENIIN	VB
MWPNIM	VB
GWNIM	NN
AWZNIW	NN
KDLQMN	RB
PIBW	NNP
821	CD
BISS	VB
TIPSQ	VB
LZMN	VB
HPTET	NNT
LHSTMK	VB
HTREMTI	VB
AIRWPIWT	JJ
HGWNH	JJ
BITIWT	NN
NBWK	VB
DRIFWTIHM	NN
HFTKNE	VB
MBNI	NNT
AWBIIQJIWWIT	JJ
IDW	NN
IIFWBI	NNT
GLWIWT	JJ
ZWNH	NN
5.22	CD
IDH	NN
IDI	NNT
ZKRW	NN
ANIIT	NNT
NJL	VB
XMSIN	NN
AWKLIM	VB
WWFINGJWN	NNP
MCJRPWT	VB
PRIXT	NNT
HWPTETI	VB
AIMHWT	NN
IWCAIM	VB
AIMPRIWT	NNT
FINWII	NNT
CWJJ	VB
AFTQD	RB
RWWQWT	NN
FWTQ	VB
SHRWRI	JJ
PWXD	VB
FEN	NN
TWFBI	NNT
SKSWKIM	NN
LHXLF	VB
HMFKH	NN
FEH	NN
EMWDIM	NN
FET	NNT
FER	NN
WWSJHAM	NNP
LHXRIM	VB
IPANIWT	JJ
APRIM	NNP
HIJLR	NNP
DBRW	NN
MWECT	NNT
MWGDLIM	JJ
PWRWM	NNT
MRKZH	NN
MAMR	NN
LFJWP	VB
DIPLWMJIM	NN
MWPEL	VB
ITQBLW	VB
FJWIWT	NN
KIPH	NN
PRNSH	NN
4391	CD
MWECH	NN
MAMC	NN
RWWX	NN
GRST	NNT
IBNH	NNP
AINJLQJWAL	NN
EINW	NN
NEWC	VB
GRMNISJ	NN
MSR	VB
ERMWMIWT	NN
PRSWMT	NN
FKIR	NN
RWWI	JJT
GRWJSQI	JJ
MSK	NNT
MSI	NNT
EINH	VB
HREIPW	VB
MSE	NNT
QFIXWIWT	NN
SIWM	NN
MBQIEIM	VB
GRSH	NN
SPWRJAI	NNT
AQS	MOD
MWNIT	NN
SPRJQ	NNP
MWNIM	VB
KXWF	JJ
MGNJIT	JJ
DRG	NN
KXWL	NN
WILIAM	NNP
AQJ	NN
DWR	NN
LQRWT	VB
DWQ	NN
MCWPWT	VB
BLIIND	NN
BSISIWT	JJ
RWBLIM	NN
MWKRWT	JJ
FLMH	NNP
SXWR	NNP
GBINH	NN
MGWNH	JJ
GLIL	NN
GLIM	NN
MFWLBWT	VB
BRNZWN	NNP
GLIQ	NNP
LQRWA	VB
DWD	NNP
MIIDIT	JJ
DWN	NNP
NRAIM	VB
DWM	NNT
ARNQW	NN
AMTNIIM	JJ
SWBIIJIM	NN
XBRWN	NNP
MMMNIM	JJ
ABHWTW	NN
HSTKM	VB
ITRWN	NN
ITRWM	VB
MXFB	NN
MCRIWT	JJ
IIMKR	VB
MBQFWT	VB
WWIMBLDWN	NNP
TQLWT	NN
HFPET	NNT
HTLQJW	VB
SWKNI	NNT
JENTM	NN
HWFTLW	VB
345,000	CD
QWMWNIZM	NN
KRM	NNP
ARCW	NN
MPQXT	VB
EIRWNI	NNP
ISWDWT	NN
MNWXH	NN
MWQDI	NNT
ANJWAN	NNP
HFPEH	NN
MWQDM	JJ
XIIBT	VB
LALTR	RB
HWNHGH	VB
PEILWTM	NN
BIIJS	NNP
NLWWH	VB
PEILWTH	NN
WIDWIIM	NN
SIPWRIM	NN
HWXRMW	VB
HMFKT	VB
HMFKW	NN
SIPWRIW	NN
SWCIALI	JJ
MMWNIM	NN
AMINH	JJ
PEILWTW	NN
FAIBH	NN
HWNHGW	VB
IFIMWN	NN
CIGLHAWZ	NNP
ABWLWP	NNP
RFWT	NNT
QLIEH	NN
MEIN	MOD
HLWWAWT	NN
HANA	NNP
KLKLNIM	NN
DAQWWRT	NNP
LPGWE	VB
NCRWT	NN
DLDWL	NNT
XLWMWT	NN
RFWM	NN
RIFQWLNIQ	NNP
QIBWCNIQ	NN
XBL	RB
NITWXIM	NN
ENIINI	NNT
ENIINH	NN
EGWMIM	JJ
MWBARQ	NNP
BWSJWN	NNP
HIKWN	NN
NIWWKX	VB
MDBIQIM	VB
RIMWNIM	NN
WWILWN	NN
AWBSSIWWIT	JJ
TESWQH	NN
DWWI	NN
JRNSPR	NN
DWMIM	JJ
2,200	CD
ETWDWTIH	NN
TLMWDIT	JJ
LHWBIL	VB
QWMC	NNT
ALIZBT	NNP
AWSJRWBSQI	NNP
AIKWT	NNT
AEIR	VB
IFRALIIM	JJ
QWMI	JJ
QWMH	NN
TXDL	VB
IPWT	JJ
QWMT	NNT
PWLIJIT	JJ
GWRBI	NNP
XIWKW	NN
MLKWTIT	JJ
GWIS	NNP
REILIM	JJ
FPIKWT	NNT
HWNAH	NN
MWKT	JJT
GLADIW	NNP
MWKR	NN
XWBBNIWT	JJ
LBDWQ	VB
MIEARI	NNP
XAGBI	NNP
DWMLIH	NNP
MNIWT	NN
HBDN	NNP
QWRWZIH	NN
HBDL	NN
PRSJIGQWSMJIQS	NNP
100	CD
101	CD
MWKI	JJT
104	CD
ATIWPIT	JJ
IMNIIM	JJ
MFKNE	JJ
MKWER	JJ
XWLIM	NN
TWKNIWT	NN
MEWNIINIM	VB
AGWZI	NNT
MFKNH	NN
IIQBEW	VB
SAJIRH	NN
KLKLT	NNT
MTMDT	JJ
QISRIH	NNP
GWNSWN	NNP
SPRWTI	JJ
BRIJIT	JJ
ENNIM	NN
HPRDH	NN
RWIJR	NNP
ANWFI	JJ
ANWFH	JJ
LXDD	VB
LXDF	VB
MGWNIM	JJ
EIIPWT	NN
10000	CD
PRSJRWIQH	NNP
EWRRIN	NN
XWMH	NN
TWRT	NNT
NKWNWT	NN
HWTQPW	VB
TWRQ	NNP
TWRM	VB
EFWR	NN
TWRN	JJ
HTABDWTIT	JJ
LHWEID	VB
BINWI	NN
PQWLJWT	NN
GBWLWT	NN
XISKWN	NN
WRWN	NNP
TLMWD	NNP
MEMDH	NN
MNXILI	NNT
BWF	NNP
MEMDM	NN
HIQPIM	NN
MAMNW	NN
MELIB	VB
GSIQH	NNP
MAMNM	NN
MAMNI	NNT
MZRIMIM	VB
ATIWPIH	NNP
MEMDW	NN
ARZ	NNP
HWRKB	VB
TGID	VB
QWRBNWT	NN
TGIF	VB
TGIB	VB
ARWJIQH	NN
LPQPQ	VB
GWBRIM	VB
JWRPDW	NNP
LHKRIZ	VB
XFBWNN	NN
MWCLX	JJ
XTIMH	NN
AIDIAWLWGIIM	JJ
XFBWNH	NN
FIEWL	NN
EWQBT	VB
LHTXIIB	VB
MKNIM	VB
BWDDWT	JJ
LHPWK	VB
10,000	CD
IKWLTN	NN
ZWJR	JJ
FIEWR	NN
XWDFIT	JJ
XMWRWT	JJ
RHIJIM	NN
DIPLWMJIWT	JJ
LHKRIE	VB
QMXI	NNP
JKNWLWGIH	NN
CDQH	NN
IRIB	NN
MGWIIS	JJ
BIWLWGIH	NN
ARGNJINAI	JJ
SIRNWT	NN
IPWRSM	VB
PRJIT	JJ
TFXRR	VB
CMIXH	NN
NWJRDM	NNP
TQRIWT	NN
QWNPWRMISJI	JJ
AWHL	NN
MFWTPT	JJ
TEFIITIWT	JJ
AWHD	NNP
BIQRNW	VB
TDWN	VB
BINI	IN
FWLXIM	VB
SDWM	NN
LBWA	VB
QRIJIWT	JJ
LBWF	VB
BWHQIM	JJ
TLT	MOD
QRWBWT	JJ
SINNTI	VB
685	CD
HLBFH	NN
BINW	NNP
XISWL	NNT
MWFKIM	VB
HKFRH	NN
IIECRW	VB
AIZWR	NN
PWLIJWRH	NN
MINLBAIIAB	NNP
IWCAT	VB
IWCAW	VB
IWCAI	NNT
HRKIBH	VB
HFPETM	NN
XQR	VB
TIAWM	NN
EINIH	NN
IMWNH	VB
FAJ	MOD
PQIDI	NNT
PRF	VB
LTXWM	VB
PRC	VB
FXQNIW	NN
PRL	NNP
AINJLIGNJIT	JJ
NRKF	VB
PRI	NNT
HJQWN	NNP
MCIEIM	VB
QWRQ	NNP
QWRN	NNP
LHTABD	VB
8491	CD
RELH	NN
PRQ	NN
PRS	NN
PRR	NNP
NDRFW	VB
FAN	NN
ASTR	NNP
NDRFT	VB
PRX	NNP
HTEQFH	VB
QWRA	NN
HXZRT	NNT
ICIRWTIHN	NN
HTIIXSWTW	NN
HXMRT	NNT
7,685	CD
QMCW	VB
GWFIM	NN
XNIH	NN
PWGFT	VB
SNAJ	NN
SIJWNAIIM	JJ
BRKH	NN
HWXL	VB
DIIGW	NNP
TFWMWT	NN
WTIQH	JJ
PNXS	NNP
NIWQASL	NNP
AMRT	VB
AMRW	VB
HFPETH	NN
MWARKT	JJ
KWTRT	NN
MPQDI	NNT
XIDWF	NNT
RPWAI	JJ
RPWAH	NN
MAXRI	IN
TPSH	VB
IRQWT	NN
MTGBFIM	JJ
HRIM	NN
LQWXH	NN
EISH	NN
IRQWN	NN
PWRJRJIM	NN
LFWNWT	NN
TPSW	VB
BLNIGRD	NNP
IXDIW	MOD
MPQDT	NNT
LBLWJ	VB
LHIGRM	VB
GREIN	NN
SIAJL	NNP
DWGLWT	VB
ICWRIM	NN
RIWS	NNP
MWZNX	JJ
TERWBT	NN
LPLG	VB
IJILW	VB
NICWLT	JJT
ASJRAJGIIM	JJ
NLK	VB
HWPKWT	VB
XWJA	VB
FWLMH	VB
HTNGDH	VB
MFWXRRIM	JJ
NENIM	NN
MZWMN	NN
HXLJTW	NN
DWBRWT	JJT
HXLJTM	NN
JWRQI	JJ
HXLJTH	NN
SIRWBH	NN
NJLW	VB
HDRGTIT	JJ
XBRTIT	JJ
HTNGDW	VB
AMCE	NNT
NRQMW	VB
AWBSSIWT	NN
NRQMT	VB
IIQBE	VB
QICWR	NNT
LARX	VB
MSPIQWT	JJ
EDWTW	NN
GZEN	NN
RKIM	JJ
FWAPIM	VB
CWBET	VB
HPCRWTIH	NN
PKWWR	NNP
LARI	NNP
SIWEN	NN
RXWBWT	NN
MJHW	NN
MFDRIM	VB
ERWMIM	JJ
LBIDIM	NN
MFNH	NN
FXRWR	NNT
RIALIWT	JJ
IWMIWT	JJ
TGRWM	VB
RWBNW	NN
ZKRIH	NNP
TWMKIM	VB
HRWWIX	VB
SPJMBR	NNP
HXJIAW	VB
HCILW	VB
AIMWNIM	NN
TRBWTM	NN
TPQIDW	NN
TRBWTI	JJ
TRBWTH	NN
RMT	NNT
NKTBW	VB
RMZ	NN
BQWFI	RB
LNW	VB
QAMINGS	NNP
AXBAR	NNP
CPIRT	NNT
GABDWLH	NNP
ECTI	NN
JWBAS	NNP
NSXRW	VB
MWTXM	JJ
ECR	VB
LHTPWCC	VB
HSJWN	NNP
NKTBH	VB
TPQIDM	NN
RMH	NN
RMI	NNP
RMN	NNP
TPQIDI	NN
TPQIDK	NN
061	CD
NLQXW	VB
RDIPWT	NN
MECBI	NNT
067	CD
TQCIB	NN
FIRWT	NN
MEWDKN	JJ
AIKLSW	VB
QLIIJWN	NNP
PINH	NN
MTQPH	NN
MRDIMIM	JJ
LBNT	NNP
MMFLH	NN
NLQXH	VB
ARKIJQJIT	NN
MWDEH	NN
MWDEI	NNP
NPGEW	VB
QJIGWRIH	NN
WGMN	NNP
BEIITIWT	NN
CEDIM	NN
CEDIH	NN
NPGEH	VB
RWBE	NN
CINWRWT	NNT
LNDWD	VB
ANWJWNIWS	NNP
MSTER	VB
MBWSSWT	VB
KWKBIHN	NN
NKSP	JJ
NWHLIM	NN
CNWE	JJ
CLILH	NN
TBWCE	VB
PFJNIWT	JJ
BGDD	NNP
NBIA	NN
IFTTPW	VB
14132830	CD
NKSI	NNT
NPAL	NNP
LXRWJ	VB
MRKZ	NNT
MILWAH	ZVL
ADIDS	NNP
GWWNIM	NN
LBWTIHN	NN
IRIETK	NN
LXRWG	VB
DMIWNIT	JJ
HIDBRWT	NN
MBJLT	VB
XWBRWT	NN
FWRR	VB
IFTTP	VB
GRMNIT	NN
LQLWJ	VB
FKN	IN
FWRT	NNT
MIQWMW	NN
SIQWR	NNT
GRWFH	NN
MINHLI	JJ
MWPT	NN
PNSIWT	NN
MGBLWTIW	NN
MWPQ	VB
PSWQ	NNT
FKR	NN
FWRH	NN
MIDT	NNT
GRMNIH	NNP
AIKRIM	NN
EBDLL	NNP
MSWBSDWT	JJ
MDBQWT	NNT
MTBSST	VB
PEWLWTIW	NN
ZWJRIM	JJ
LHTBCE	VB
NKWN	JJ
LWWIITN	NN
RXWQ	JJ
CIDWQ	NN
AWLIMPI	JJ
EILT	NNT
ASPQJIM	NN
EWLMI	JJ
MECRIM	NN
EILH	NN
NMKRIM	VB
HFFI	ZVL
MRIEIM	VB
EIWWRT	JJ
NERC	JJ
LHNHIG	VB
NMWKIM	JJ
QRNIIM	NN
MGUD	NN
AWT	AT
LMCWT	VB
MQL	VB
ICIBWT	NN
AWP	NNP
AWN	NNT
MQS	NNP
TSRIJ	NN
AHRWNWB	NNP
HWDRKH	VB
AWI	RB
LMCWA	VB
MWFPEIM	VB
DIAMWND	NNP
KWWNH	NN
TTN	VB
DQT	NNT
AZRXIIM	JJ
LFTP	VB
MFTWLL	VB
ZWRNL	NNP
MEWJRWT	VB
DIRQJWR	NN
QWNPLIQJ	NN
WTIQIM	JJ
HTIIXSWIWTIHM	NN
FBRIH	NN
NADIRH	NNP
DMIM	NN
IAWT	NN
TITQL	VB
ADIRIM	JJ
GIFTW	NN
DQH	NN
MZKIRH	VB
HZDRZ	VB
FWNAIM	VB
ECMAIT	JJ
ISWDW	NN
HWKIXW	VB
ALWZIWT	NN
IWRFE	VB
RAFITH	NN
HWBLWT	NN
XMIFI	NNP
XMIFH	CD
LNGWE	VB
ISWDH	NN
ISWDI	JJ
MIFXQIM	NN
SDRWT	NN
NWPLT	VB
MCRIIM	JJ
MZKIRT	NNT
WIINFJIIN	NNP
MTELM	VB
IWGF	VB
BQRH	NN
DXISWT	NN
EWQC	NN
XWBWT	NN
DRWRI	NNP
QWBRIM	VB
CILWMIM	NN
SWPRH	VB
PISI	JJ
MWQDMT	JJ
TIMFK	VB
02	CD
03	CD
TPQID	NN
06	CD
07	CD
04	CD
05	CD
PAXM	NNP
HSKIMW	VB
NAWTIM	JJ
09	CD
MAZN	NNT
XFWB	JJ
HSKIMH	VB
FWJPIM	JJ
PSIKWLWG	NN
HCLXTW	NN
MFPXTWN	NN
BAWZNI	IN
EIWWRWN	NN
AWSJRLI	JJ
HAFMWT	NN
MRWKSNWT	JJ
MNIX	VB
MEWZ	NNT
KPRI	NN
GWRNAL	NNP
385	CD
MNIE	NN
HALH	NNP
MNIN	QW
IZWMWT	JJ
HTQWMMWT	NNT
XWUL	NN
QWRBN	NNT
XGIM	NN
MWJB	VB
PARIJ	NNP
GAJUJ	NNP
ALINH	NNP
CDQT	NNT
LHFTMF	VB
FIJPWN	NN
MMFIKH	VB
MQWRBIM	VB
LHWZIL	VB
MAPIINT	VB
LHBHIR	VB
MWCRJ	NNP
LBNWN	NNP
ZZ	VB
MXCIT	NN
MLAKWTI	JJ
SIMWN	NN
GWLIM	NN
SRJNIM	NN
MLIM	NN
MLIN	VB
DM	NN
MLIH	NNP
NQLEIM	VB
MIWEDIM	VB
ICWA	NN
AWRNIM	NN
BWAKH	NN
BWDAPFJ	NNP
MLIC	NNT
DETI	NN
DETH	NN
MRKZIT	JJ
DETM	NN
C.	NNP
AWFRW	VB
LIHNWT	VB
PRSLNI	NNP
DI	RB
HWA	PRP
GWWE	VB
BXINT	NNT
FGRTI	JJ
AWFRI	NNP
GWWN	NN
MRKZIM	VB
MIGBLT	NNT
DETW	NN
MRKZIH	NN
KSPW	NN
ADIR	JJ
CH	NNP
PICWIIM	NN
CL	NN
MWJLW	NNP
IPANIIM	JJ
FLIJ	NN
CWPRIM	NN
HGDIL	VB
01.3	CD
HGDIR	VB
AIKWTW	NN
HWMRWS	NNP
01.4	CD
CR	VB
LMSWR	VB
KSPM	NN
CW	NN
QWBNIT	JJ
KSPH	NN
NMLJ	VB
MTMFK	JJ
ASTJIIM	JJ
NFIAT	NNT
NAMD	VB
LHGFIM	VB
NIHWLIWT	JJ
HIQPN	NN
IEQB	NNP
QWDRI	NNP
HIQPI	NNT
HTLBJW	VB
HIQPW	NN
HCEWTIW	NN
HKTIBH	VB
ETIRH	NN
yyQM	yyQM
ITGFMW	VB
WEDH	NN
NXSK	VB
HWLMIM	JJ
WIKWXIM	NN
BANPILD	NNP
HMWMIM	JJ
LHENIF	VB
TIKNWN	NN
XCAI	NNT
LXFB	VB
HWQIEH	VB
GLILI	NNP
NQIFTI	JJ
NZQIM	NN
DW	MOD
TXMWFT	NN
LHENIQ	VB
MZKIR	NNT
LWRIAL	NNP
DBWRH	NNP
MBQFT	VB
KKL	IN
NXZH	VB
DR	NNT
RWMAIT	JJ
LIICR	VB
BXINH	NN
MKIM	VB
MKIL	VB
ANJWNIWS	NNP
MPIQH	VB
MMHR	VB
BRQWBIC	NNP
INWDH	VB
AINDIANIM	NN
DBIQ	JJ
FABH	VB
XIMWM	NN
HIJMEWT	NN
098891	CD
HIEDRWTW	NN
HIJIBH	VB
LICWR	VB
HKNIS	VB
LMTWX	VB
MNEH	VB
HERIKW	VB
IEBRW	VB
XBIBIM	JJ
GIDWP	NN
LAMC	VB
FPWT	NN
FPWP	JJ
NIPC	VB
HTGWRRW	VB
MNWKRT	JJ
LAMR	VB
LAMT	VB
HICEIM	NN
TFIFWT	NN
AIZMIRLI	NNP
801	CD
800	CD
GIDWL	NN
FPWI	JJ
TNWEWTIHM	NN
JJRIM	NN
KWNW	VB
GDEWN	NNP
KNWPIWT	NN
QWLQJIWWIWT	NN
ZKTH	VB
ZWHR	NNP
PTLTLIM	JJ
HRMJIT	MOD
QWMPWRJ	NNP
PIPUA	NNP
MFPXTNW	NN
ERBI	JJ
ALLH	NNP
GBETI	NNP
BWLJT	VB
MTNPL	VB
NLXM	VB
QICWNIM	NN
AJALNJH	NNP
PWZWT	NN
ERIKH	NN
MRQMIM	NN
HXRIMW	VB
119	CD
XIBWRIM	NN
MWSJPH	NNP
AINJLQJWALI	JJ
EPEWP	NN
MWSJPA	NNP
HFTQPWT	NNT
KWABWT	JJ
MTXIIBIM	VB
IWRFH	VB
HFETH	VB
XMWT	JJ
MNIIRISJIT	JJ
NZHRW	VB
XMWR	JJ
IICWB	NNT
PIRSM	VB
QRNWT	NNT
RABW	NNP
MILAW	VB
MWRKN	JJ
APIZWDH	NN
MILAN	NNP
LHTGIIS	VB
FXIIH	NN
NKFLTI	VB
MFMEWIWT	NN
XSR	JJT
SIET	NNT
HKFLT	NNT
IWRM	NNP
LDKA	VB
MAWHB	VB
LHIABQ	VB
HWFBE	VB
PICWII	NNT
MWSJAPH	NNP
XIKH	VB
HWDWT	IN
XSD	NN
GRIIJ	NNP
IWRI	NNP
TXPWFT	NNT
KLIL	RB
GWRLN	NN
KLIH	NN
CBEIM	NN
NGRS	VB
MAWFRT	JJ
PTE	RB
MCIAH	NN
CIINW	VB
CIINT	VB
NQLWJ	VB
HJBWT	NN
FJWJGRJ	NNP
CIINH	VB
CIINI	NNP
NGRM	VB
PTX	NNT
MFTME	VB
KLIW	NN
MFTMF	VB
DIAMNJ	NNP
QWLWNL	NN
MLWAH	NN
HTPTX	VB
ZIRW	NNP
FWME	VB
MXMIRIM	JJ
LXILWPIN	RB
FWMN	NN
NQJET	VB
FWMR	NN
NQJEH	VB
LHGIE	VB
IDIIM	NN
ZIRH	NN
MLWAW	NN
MWRKBT	JJ
IEQBI	NNP
HNDLZLC	NNP
TIIRT	NN
RIGWL	NN
TNCX	VB
MWMXIM	NN
WDAIT	JJ
MSQNWTIH	NN
ABRNATI	NNP
BIJWLW	NN
CWDQT	JJ
CMXI	NNT
HMTIN	VB
QWLJWRH	NNP
TXZIWTIW	NN
GINTH	VB
FRIDIM	NN
NSTGR	VB
FJXIT	JJ
PWRNIR	NN
PWRJR	NNP
BRWQLIN	NNP
XRJH	NN
HRGL	NN
MKTBW	NN
XRWN	NNT
PNIMIIM	JJ
MPWQPQT	JJ
NELM	VB
IEDI	NNT
PNIMIIH	NN
NELI	NNT
NELW	VB
SUS	NNP
MIFHW	NN
JBLT	NNT
MEMIDWT	VB
WWDI	NNP
32.40	CD
EIQR	NNT
HTLHBWTM	NN
TPQWDW	NN
MEFIW	NN
MEFIT	JJ
MWT	NNT
MNSRT	VB
HTNKRWT	NN
MEFIM	NN
FAPTNWTW	NN
TWLET	NNT
TPQWDH	NN
TPQWDI	JJ
NBE	VB
TPQWDM	NN
NWRMWT	NN
MLXMTIT	JJ
EWCB	VB
RZRB	NNP
BNIIH	NN
HWCG	VB
HWCE	VB
DNI	JJ
DNH	VB
HWCA	VB
SWHR	NN
DNW	VB
ALWP	NN
GILWIIM	NN
TTMWDD	VB
XWDW	NN
AWMNSQI	NNP
HWCT	VB
BSISIT	JJ
221	CDT
NFKBW	VB
SIPQW	VB
LGMWR	VB
THIWT	NN
HQLH	NN
DHIINW	RB
HQPWT	NN
MNEMI	NNT
TIQWN	NNT
MFLH	VB
HQDIMW	VB
KTWBH	JJ
MFLM	VB
EINIHM	NN
MKWWN	VB
MFLB	VB
CWEDIM	VB
RCITI	VB
QCB	NN
MEBRIM	NN
RWBN	PRP
XWFPIM	VB
KLKLIT	JJ
TIKWNISJIT	NN
MKSXI	NNT
KTWBT	NN
AWIRH	NN
MQWRI	JJ
LGIIS	VB
RKZ	NN
MQWRM	NN
SWLIDI	JJ
RKF	VB
MNTXI	NNT
MQWRW	NN
RKB	NN
AWMAHRH	NNP
LGDWL	VB
RKH	JJ
LHXMIC	VB
RIQH	JJ
RIQI	NNP
081	CD
085	CD
LFEFE	VB
PNJSIH	NN
MIWMNWT	NN
MTQRB	VB
112.90	CD
TQFWRTIT	JJ
XJPW	VB
MNIXIM	VB
NWR	NNP
MWPNMT	VB
MKNSI	NNT
XDRH	NNP
XDRI	NNT
XDRW	NN
MWDGF	JJ
BWL	NN
MWFPE	VB
QBILWTN	NN
NWTNIM	VB
HTRGFWTM	NN
TWMKIH	NN
IDXH	VB
DRBI	NNP
HWFIEW	VB
ARWBH	NN
KITH	NN
ADWMH	JJ
MIRB	NNT
1.6.90	CD
NSBLIM	JJ
MKLLWT	NN
NBKI	NNT
EWSQIM	VB
ADRIKL	NN
5.63	CD
PQWDT	NNT
MTEWRRT	VB
TWMKIW	NN
BNDWRI	NNP
RWBRS	NNP
TWMKI	NNT
GNBWT	NN
JRIISI	NNP
IMMFW	VB
NWFAWT	VB
QLJW	VB
ANFIW	NN
HTRKZW	VB
0	CD
MAWXR	RB
ANFIH	NN
ANFIM	NN
NIJRLH	VB
HFTKRWT	NNT
AIWWLIN	NNP
EIWWTIM	NN
FIR	NN
IFNM	VB
MWRA	NN
NBXRW	VB
ZINWQ	NN
NBXRT	NN
JBXWT	NN
MFMIE	VB
FIX	NN
MWRN	NNP
LHJ	NNP
GMII	NNP
MBCEIIM	JJ
FWPK	VB
FWPJ	NN
MWRW	NN
IKBD	VB
MSMLIM	VB
FIJ	NN
QRATI	VB
NBXRH	VB
FIM	NNT
MKWERT	JJ
MTAIMH	VB
TFTIT	NN
SSJRI	NNP
DIIBI	NNP
PISARW	NNP
MERICIW	NN
MAHBIM	NN
ETWDWT	NNT
TXLIP	VB
LFXRR	VB
NWXIWT	NNT
AIPFR	VB
TXLIJ	VB
WS	NNP
HTKWNNW	VB
HQRIN	VB
TWHIM	VB
EINI	NNT
FKMW	NN
FBITT	NNT
IBBT	NNT
LHZIQ	VB
QAM	NNP
HXLIFW	VB
NPCEW	VB
MHIRI	NNT
MHIRH	JJ
NBLEW	VB
APQJIWWI	JJ
MWPFJ	NN
MXBLIM	NN
IWFB	VB
ALAN	NNP
MCWIN	JJ
MCWIH	VB
MCWID	JJ
JMWN	VB
3,086	CD
AWMLLWTM	NN
IWFR	NN
XIPWFIH	NN
AIKWTI	JJ
ANALI	JJ
MJIILIM	NN
QAJ	NN
EFRIM	CD
MRIC	VB
TIQIM	NN
MRIN	NNP
BIZARIT	JJ
MRIM	NNP
MRIW	NNP
WWEIDH	NN
JRANSPR	NN
MTQDMT	VB
MZERIWT	JJ
RXWQWT	JJ
KWABT	JJ
IWRDT	JJ
SIBIR	NNP
MXBR	NNT
SIBIT	NN
XSRWNWT	NN
SIBIM	NN
EREWRI	NN
XBLH	NN
AGDWT	NN
IWRDI	NNT
SWWINDWN	NNP
TPWZIM	NN
EWSQ	VB
MZDHWT	JJ
MFTBCIM	VB
NQBR	VB
NQBL	VB
MMTINIM	VB
BEIWT	NN
HARJS	NNP
LCBWE	VB
NQBE	VB
2,734	CD
MPWSJR	JJ
RWMNIIH	JJ
AIGWDIM	NN
FBWIIM	NN
JRAC	NNP
LQIIM	VB
QRSWLIHN	NN
0507	CD
HZMINW	VB
QRIIT	NNT
SRQZM	NN
QTWLIT	JJ
RAITI	VB
MCPIM	VB
MWACT	JJ
KPPH	NN
HTXIIBWIWTIH	NN
HTWWIIT	NNT
SIDWN	NNP
KDWRGL	NN
BNQS	NNP
XLIPIN	NN
DWMINNJI	JJ
MEUM	NN
MFPIEH	VB
SPRWTIIM	JJ
JENW	VB
SIDWR	NN
IXIIBW	VB
552	CD
EILAI	JJ
MEUC	NNP
LHDAIG	VB
QNSWT	NN
LHFTKR	VB
EFIRIM	NN
MPLGT	NNT
XBRIHM	NN
ZQIM	NN
MTARGNT	JJ
QWFINSQI	NNP
MMFIIM	JJ
XWBBIM	NN
MPLGH	NN
SPWNJANIT	JJ
EFIRIT	JJ
ALIHW	NNP
NXIFWT	NN
HIERKWT	NN
DALDH	NNP
TLKID	NN
HQMTM	NN
MWFBWT	NN
HTNPC	VB
MLKT	NNT
HQMTH	NN
HQMTW	NN
MLKH	NN
GWLDH	NNP
GZRIM	NN
HTNFAWT	NN
AWGRSHIIM	NNP
MLWN	NN
ZHWT	NN
HFQEH	NN
AWFPZ	VB
HNHLT	NNT
BJRM	IN
MITWN	NN
MITWS	NN
LBNWNIIM	JJ
LNGX	VB
HNHLH	NN
MTXBJIM	VB
HFQET	NNT
MFIXI	JJ
MFIXH	NN
HBINW	VB
HKRXI	JJ
MMLAH	VB
MMLAI	NNT
EIJWR	NN
MRKBH	NN
AXIDIM	JJ
BWDQT	VB
ACJDIWN	NN
149	CD
NHIRH	NN
QWWIN	NNP
MMLAT	VB
MTEMLWT	NNT
EDIIN	RB
FWXRR	VB
HBINH	VB
LDXWQ	VB
MIEWJ	NN
MATIW	NNP
QZAN	NNP
XIILT	NN
NSGR	VB
HFKLTN	NN
MTXFBT	VB
DWRWTIW	NN
XIILI	NNT
LXQWR	VB
NWSPIM	JJ
MNHLWT	NNT
SJAZ	NN
MQSIM	NNP
XIW	VB
HQFRIM	NN
LIPIN	NNP
HSTBKH	VB
MMFL	NN
WTQ	NN
TSBIK	NNT
MMFI	JJ
GBRIALH	NNP
GBRIALI	NNP
FLMIM	JJ
SBIB	IN
QWNCNZWS	NN
AQJWARI	JJ
MNHGW	NN
PSWL	JJ
ARGWNIM	NN
LKSWT	VB
HSRT	NNT
SBIR	VB
TRGIL	NN
MFWPFPIM	NN
MKIRWT	NN
IIB	NNP
ALMNJRI	JJ
FIXZR	VB
KIMAI	NN
AXZQH	NN
APWS	NN
LHQFIB	VB
QRDIWLWG	NN
LIWWRPWL	NNP
LKBWF	VB
LKBWD	IN
KIFLWNWT	NNT
MTINWTH	NN
MTABLIM	VB
ITQWP	VB
HPKW	AUX
MQWRBW	NN
LKBWT	VB
MFPJIIM	JJ
IAXR	VB
HTBQFH	VB
ZWL	JJ
PAFISJI	JJ
DINM	NN
ERWBH	NN
ADMWT	NN
MZIQI	NNT
LWWDA	VB
ZWG	NN
DINW	NN
APRIL	NNP
MSWLP	JJ
ZWNX	VB
HDLIP	VB
SBWRIM	VB
HTBQFW	VB
TNWEWT	NN
ZKRM	NN
TNWEH	NN
PWNIM	NN
SEIPI	NNT
LWXMIM	VB
SEIP	NN
HWGDRW	VB
KWLSJRWL	NN
BRIAWT	NN
IWFBE	VB
EMWSH	JJ
ANIMCIH	NN
RMJ	NNP
SIRWBAJQW	NNP
AIRWNI	JJ
GREINIWT	JJ
JLWIZIWT	NN
SEID	NNP
MCPH	VB
HNXTT	NNT
IWFBT	VB
LSDR	VB
TPAWRH	NN
G	NNP
BEIH	NN
XWWH	VB
ESQNI	NNT
TWKPL	VB
AWRWWLIANI	JJ
HGETI	VB
MWSJRL	NNP
GLRWN	NNP
MWRIH	NNP
AWPWZICIH	NN
AWDN	NNP
MWRIM	NN
MF	IN
NGZR	VB
NICXWN	NN
JQBASRN	NNP
NERKWT	VB
RALP	NNP
BIJA	VB
NLWWIT	VB
MELIT	NN
PRJIW	NN
QBWEWT	JJ
SIEWT	NNT
LWIN	NNP
DEIM	NN
LWIH	NNP
LWIJ	NNP
IWQJNW	VB
HBXINH	VB
TNAI	NN
AIKWTM	NN
BFMIM	NN
RIBWNIT	JJ
QBWCTW	NN
HPEIL	VB
IMNIT	JJ
XIIM	NN
XIIB	VB
PRWDWRMWL	NNP
HTPREWIWT	NN
HBXINW	VB
IXZWR	VB
NPFIWT	JJ
XUK	NN
KLWT	NNT
MTXMQWT	VB
NXLC	VB
QLILWT	NN
LPNI	IN
HBXIN	VB
QJEI	NNT
MPRFIH	NN
JKS	NNT
EISQWT	NNT
HTEQBH	VB
MMCIA	NNT
WWAFINGJWN	NNP
KLWM	NN
PRWJSJNJIM	NN
APRWXIM	NN
ELIIT	NNT
CALX	NNP
SIKWIIM	NN
SIKWIIK	NN
FWKN	VB
HMNWN	NN
FRI	NNT
TKTWB	VB
TWMKT	VB
MWPQT	VB
NICWLIM	JJ
FWKX	VB
FRR	VB
FRP	NNP
KRWKWT	JJ
MCBIEIW	NN
SIKWIIW	NN
BNJWB	NNP
GIAWGRP	NN
RPPWRJ	NNP
WWRQRS	NNP
DIRTW	NN
QCR	JJ
10	CD
13	CD
12	CD
15	CD
14	CD
17	CD
CIBWRIWT	JJ
NWKX	IN
18	CD
LDXWT	VB
AWMR	VB
LISJ	NNP
MAJ	NN
BBQFH	RB
JIIPWN	NNP
CNZWRH	NN
XILWT	NNT
NWKL	VB
MFMEIT	RB
DN	NNP
DL	JJ
ALBIJ	NNP
ZWSMN	NNP
EIWN	NN
DH	NN
350,000	CD
MGLH	VB
GAWWTM	NN
SWRIM	NN
DB	NNP
MGLM	VB
SWG	NN
DA	NNP
PIRMIDH	NN
SWRIT	JJ
DTIT	JJ
QNDH	NNP
MRKWS	NNP
SWP	NNT
NENW	VB
QCP	NN
MRWBIM	JJ
DQ	JJ
TGR	NNP
AIFWMIM	NN
MATIIM	CD
BIMWI	NNT
SWNJWT	NN
PFIJWT	NNT
AWSMNWB	NNP
ERBH	NN
BIMWT	NN
QNIG	NNP
HKNWTIW	NN
201	CD
200	CD
IXSI	NNT
ELWBI	NNT
NIMWSIM	NN
TKNIT	NN
PXTW	VB
NXLQWT	VB
IIHPKW	AUX
SWNG	NNP
TKNIM	NN
XWFD	VB
WWEDWT	NNT
FIAW	NN
TKNIH	NN
XWFB	VB
IXSR	VB
MWFGIM	NN
WWTIQWT	JJ
XIBH	NN
TFUT	NNP
SIKWNIM	NN
XWFK	NN
MWLDT	NN
HSTPQW	VB
SJAZRIM	NN
MMFLTH	NN
MMFLTI	JJ
EBWDTW	NN
BPIRWF	RB
MAN	NNP
ISPWG	VB
FKIRI	NNT
HTREWT	NN
MTAXDIM	VB
EBWDTH	NN
EBWDTI	NN
LGMWL	VB
MMFLTW	NN
JQJIWT	JJ
BDLNI	JJ
FGRTIIM	JJ
XIZWRIW	NN
MIRN	NNP
TMIHTW	NN
NDQRH	VB
PIDL	NNP
IFTMFW	VB
WN	NNP
NKNEH	VB
IKLH	VB
WI	NNP
WW	NNP
TQLWTIW	NN
HPSD	NN
XILWNIIM	JJ
NKNEW	VB
DIBWRW	NN
BARI	NNP
IXLIJW	VB
QAN	NNP
RWBRJ	NNP
MFRH	NN
IIAWFW	NN
RIX	NN
ANW	PRP
DJRWIJ	NNP
HWRXQW	VB
RIQ	JJ
IAWFR	VB
AINDWQJRINCIH	NN
RII	NNP
AMINWT	NNT
RID	NNP
HIRCXW	NN
LABIANW	NNP
ASJRAJGIT	JJ
RISN	VB
HAL	NNP
HAM	HAM
TRMW	VB
MHWMWT	NN
MIICR	VB
PRWPIL	NN
BNW	NN
MXMIC	VB
BNI	NNT
BNH	NN
IGBR	VB
FLMWT	NN
MTPLL	VB
98891	CD
MIICG	VB
HTGLWT	NN
SJAR	NNP
HAW	NNP
54	CD
SSGWNI	JJ
W.	NNP
MQIIMWT	VB
QLWT	NN
LHFTTP	VB
PARWQ	NNP
LHIEDR	VB
KFRWNM	NN
HWWARD	NNP
MWDAG	JJ
921	CD
FMWT	NN
ALIPWT	NNT
QLWF	JJ
JWNIM	NN
ISLXW	VB
HWTNTH	VB
104.90	CD
MXWLQ	VB
HEDIP	VB
BINWNI	JJ
NDQR	VB
KNIET	NNT
NKWT	NN
HDIXH	VB
NKWW	VB
119.90	CD
PJWCINI	NN
EJRH	NNP
HELH	VB
KIUL	NNP
MXWLL	NNT
QRTA	NNP
QHILWT	NN
QRTH	VB
HGDIRW	VB
MCEDW	NN
PLSJI	JJ
ANWFIIM	JJ
KLIATM	NN
ZW	JJ
NXRDW	VB
MKAIBH	JJ
HTKNSH	VB
SISMH	NN
TMWRT	IN
MWTM	NN
TWBEIM	NN
HBXNWT	NN
BERNWT	RB
HIITI	AUX
TIAMN	JJ
IFLX	VB
CPIR	NNP
BWCE	VB
TPIRH	NN
DLIL	JJ
LERB	VB
DLIH	NNP
IFLM	VB
SISMTW	NN
MWTR	VB
SISMT	NNT
MWTW	NN
MWTX	VB
AKZRIT	JJ
XQIINWT	NN
ARMISJ	NNP
PCIETW	NN
IHDWT	NN
PILWSWPIH	NN
SWJIM	VB
XWLPT	JJ
PFEIM	NN
TTBQF	VB
AXRAIWT	JJ
IICWA	NN
HTBJLH	VB
PRWWH	NN
QWNSRWWJIWWI	JJ
TMWNH	NN
AXWRI	JJ
MHNDST	NNT
QINI	NNP
LHTNAWT	VB
MHIMN	JJ
15716281	CD
NBWKIM	JJ
MPWRJWT	JJ
ANPILD	NNP
NFDDH	VB
BWJNAI	NN
SJIIN	NNP
NKNSIM	VB
HIJL	NNT
HIPRKL	NNP
PSJH	NN
SJIIH	NN
MEQWT	NNT
HIJB	RB
HWZRQ	VB
EBWDTNW	NN
HTKNSW	VB
ZWKH	VB
NAWMIW	NN
LKPR	VB
ABDW	VB
QAWBWIIM	NN
AKPT	RB
AWJWBIWGRPIT	JJ
MRGF	VB
GILIWN	NNT
PNQIIBICIM	NNP
TPR	NN
QINWX	NN
NPGEIM	NN
HIFWWH	VB
MLAWT	NNT
AWJWBIWGRPIH	NN
MAWRGN	JJ
ABDH	NN
TLWIWT	VB
HTQLSWIWT	NN
ABDN	NNT
EWCMTW	NN
QPJN	NNT
HTGLWTW	NN
NAIWWIT	JJ
MNIWTIH	NN
XBRWTM	NN
CRPT	NNP
LFPR	VB
NIIR	NN
CZNH	NNP
SWKMW	VB
DMMT	NNT
RWDN	NN
EWQBIM	VB
EWTMNI	JJ
MGMTIT	JJ
ISWDIT	JJ
NAMRIM	VB
MILQN	NNP
EIQRIWT	JJ
MAWXDWT	VB
AZWB	NN
EWUD	NN
MHPKH	NN
NCJWW	VB
LMMF	VB
CKIH	NNP
MFJXI	NNT
LEDKN	VB
LMMN	VB
BIQWF	NN
TIPQWD	NN
NWGDT	VB
EDWT	NN
AGWZIM	NN
HWJRD	VB
FAWLI	NNP
QDIMH	RB
MEWNIINT	VB
FAWLH	JJ
HBQIE	VB
KDWRSL	NN
BIQWR	NN
DQIRWT	NNT
HFPEWT	NN
AWDISIAWS	NNP
NPRDNW	VB
XBWIIM	JJ
RCIWNALIZM	NN
CWWTW	NN
FIQWL	NNT
FIQWM	NNT
FNIIDR	NNP
FIQWP	NNT
ALMNJIM	NN
0781	CD
MBXNIM	NN
CWWTI	NNT
MWNCX	VB
WWL	NNP
TFLWM	NN
AZRN	NNP
IRWD	JJ
HTPRSM	VB
PRANSWAH	NNP
JIRWNIM	NN
SBAI	JJ
SIMPJIT	JJ
XQLAI	JJ
ZIWPIM	NN
NPRSWT	VB
SWLWDR	NNP
RGFWT	NN
QLAWS	NNP
BSIWNI	NNP
PRLMNJRIT	JJ
ZRIMH	NN
XJA	VB
IIFLXW	VB
MKRZIM	NN
XWBQWT	JJT
FIKWRIM	NN
EDWIWT	NN
SLWWDWR	NNP
KPIIH	NN
XJP	VB
ENPIM	NN
MLEIJWT	VB
KMIHT	NNT
FMALNI	JJ
ICWAN	NN
EKWAIM	NN
TPQIDIW	NN
GRWN	NNT
AQZWJIT	JJ
MLMD	VB
LNER	VB
GWSS	JJ
HFBEH	NN
AWMBRJW	NNP
HPLT	NNT
NICWL	NNT
AJWN	NNP
HPLW	VB
MBIF	JJ
ALMWNIWT	NN
MXIIBWT	JJ
HWXLH	VB
4	CD
HWXLJ	VB
MBIA	VB
MBIN	IN
PSWQIM	NN
TPQIDIM	NN
MBIK	JJ
HKRZT	NNT
APQWJ	NNP
BKIRI	NNT
BKIRH	JJ
HRCLIH	NNP
APLIM	JJ
ITXZQW	VB
PWLIJIWT	JJ
HTBJAWIWT	NN
APLIH	NN
HTNXLWIWT	NN
MTPRCWT	NN
ASKWLWT	NN
AGRWNWM	NN
MSTERIM	VB
RCXNIT	JJ
GWLFWT	VB
HKRZH	NN
MTWEFWT	JJ
GWR	NNP
MXIRM	NN
MXIRI	NNT
MXIRH	NN
NCBE	VB
SWDI	JJ
GDWLH	JJ
IRIBIW	NN
NFIMH	NN
HPSQNW	VB
TXTWM	VB
TXTWN	JJ
MTNKRIM	NN
MXIRW	NN
SIJWACIWT	NN
MAWRGNIM	VB
NCBR	VB
MWFA	NN
I.K.	NNP
4891	CD
JWBIH	NNP
22	CD
JWBIM	JJ
HCHRTI	JJ
HTNXLWT	NN
TAWM	NN
BNGAL	NNP
RDIAJWRI	NNT
EFIR	JJ
MMDI	NNT
NXFQ	JJ
SXWRH	NN
AF	NN
LHTNTQ	VB
NXFD	VB
IWEBR	VB
NXFB	VB
HWWIH	NN
DIXWI	NN
IEWDW	NN
EWZRT	NNT
EWZRW	NN
BRLIN	NNP
EMNW	NN
TMWNWT	NN
DINACI	NNP
WWALIWM	NNP
MFPXTI	JJ
MFPXTH	NN
HFLKWTIHN	NN
APLH	NN
MFPXTW	NN
GRWSHDRN	NNP
LQBL	VB
RENNWT	NN
PRDWQSLI	JJ
SJIIJ	NNP
MERKWT	NNT
MFKWRT	NN
RIBWNWTW	NN
ICRIM	NN
GWPNIT	JJ
MTIIXDIM	VB
HFWWAT	NNT
HIDALGW	NNP
AP	MOD
HTNDBWT	NN
KDWRGLN	NN
NKLLT	VB
8891	CD
MWKRXH	VB
MGBLH	NN
HWRAH	NN
XRARDW	NNP
XKIRH	NN
NITN	VB
RCWIH	VB
HFLIMW	VB
KRMI	NNP
LHIWT	VB
MTPWRRT	VB
QFIFIM	NN
AW	CC
MTAHB	VB
LIZWM	VB
LWBFI	NNT
MKLLT	NNT
FNIWT	NN
ZIHMH	VB
LWBFT	VB
AX	NN
MWZIAWN	NN
ZWLH	JJ
SKINIM	NN
ZUL	NN
MCWINT	JJ
PNLWPH	NNP
KRWK	VB
MKLLH	NN
HBRXT	NNT
EMWQH	JJ
HCET	NNT
DQDQNI	JJ
MDPIM	NN
BLJW	VB
BLJH	NNP
NFPK	VB
KRWZ	NN
MCRI	JJ
SLILT	NNT
NWHGIM	VB
EBDALLH	NNP
MSEWTIW	NN
IWLI	NNP
AMNWTIT	JJ
MIAMI	NNP
LRMWZ	VB
FIRIHM	NN
QARSWN	NNP
LRMWS	VB
IHWWH	AUX
LIDTN	NN
TEFIITIIM	JJ
PIRWQ	NNT
MWRWT	NN
RWPIN	NNP
PIRWT	NN
BEIITM	NN
BWRIS	NNP
LHTIICB	VB
RMBUM	NNP
BRISL	NNP
CIWRIM	NN
XSIDI	NNT
QRWBIM	JJ
NWCRIT	JJ
CIWRIT	JJ
PIRWF	NNT
AWFR	NN
NAMNWIWTIW	NN
SWCIWLWGIIM	JJ
HSBRH	NN
LNXWT	VB
ASISJNJIT	NN
IXZIQ	VB
BIJWIIM	NN
IXZIR	VB
LBSWP	RB
XWR	NN
XWP	NNT
XWQ	NN
XWL	NNT
XWM	NN
LIQR	NN
JISWT	NNT
QWWARC	NNP
XWF	NNT
XWG	NNT
MEWN	NN
MNWSIM	JJ
NBHLIM	VB
XWC	NN
MENIINIM	JJ
11	CD
MZMN	RB
DWQRNI	JJ
HSRJT	NNT
AIDIAWLWGIH	NN
HWKNS	VB
ECRT	NN
HSRJH	NN
NLQXWT	VB
NRAH	VB
PWPWLRIIM	JJ
LTQWE	VB
ARGWNIIM	JJ
PXD	NN
FPE	NN
FIMWN	NNT
RFWTH	NN
4,000	CDT
IFWB	VB
QWLNWEIT	JJ
FPL	NNT
KRIFIM	NN
PANJWM	NNT
FPI	NNP
FPH	NN
486	CD
SPWRJ	NN
MZDMNWT	JJ
FPT	NNT
IFWW	VB
MTINWT	NN
FPR	VB
NALCWT	VB
IRCW	VB
NFQPT	VB
LNSWT	VB
IFTQPW	VB
IDIEH	NN
MAXR	IN
SIMPAJI	JJ
CEDIHM	NN
TWPEH	NN
LNSWE	VB
TWPET	NNT
MWEDPIM	JJ
BRAF	RB
MJPLWT	VB
BRAD	NNP
IEBIR	VB
IWRDIM	VB
AWNIWWRSLI	JJ
BEIITI	JJ
ALWPWT	NN
SPWRJAIM	NN
SAGH	NNP
SIP	NN
RCXW	VB
TKLITW	NN
DLTWT	NN
AZKWR	NN
DHWA	NNP
JWBTM	NN
MXLQT	NNT
FWWH	JJ
MIDIT	JJ
SIN	NNP
LHQNWT	VB
XDFIM	JJ
GLAZGW	NNP
TAW	NN
MSIIET	VB
BAIIR	NNP
MERIK	VB
59.90	CD
0991	CD
LBNWNIZCIH	NN
DMEWT	NN
MERIB	NNP
IXWLLW	VB
TAI	NNT
LHXLIF	VB
SWLR	NN
EKWR	JJ
ENWWH	NN
FLXH	VB
HSKM	NN
MHGRIM	NN
LHXLIJ	VB
IQCC	VB
FWTPW	NN
FWTPT	NN
CRIPWNIM	NN
FLXW	VB
NBLET	VB
JIQ	NN
MERBIWT	JJ
SWLL	NN
SWLM	NNT
0998	CD
ICATM	VB
DWUX	NN
WWLWNJRIT	JJ
LSIRWGIN	RB
FERWT	NNT
GIAW	MOD
FRH	VB
MJRT	NNT
RAFIT	NNT
16	CD
XRIPIM	JJ
HXMCNW	VB
SQNDINWWI	JJ
SI.	NNP
QWMWNISJI	JJ
ENPIIM	JJ
HELTH	VB
HPSQWT	NN
NDIBH	JJ
AWNNWT	NN
19	CD
MFWM	IN
MFPJ	NN
SJLMK	NNP
MIGRF	NN
PIZH	NNP
BHIRWT	NN
FLWF	CD
MKXIFIM	VB
KBF	VB
QBRWT	NN
KBD	JJ
JPFIM	JJ
MEWNIIN	VB
HMXFT	NNT
FRIRWT	NN
KBR	RB
XIWBIWT	JJ
DINGIAW	NNP
MEWZIM	NN
QWNCRN	NNT
5000	CD
MKINH	VB
JIBW	NNP
TRCW	VB
LIMWR	NNP
K	IN
MHLK	NN
NFI	NNT
QRMRB	NNP
BLM	NNT
MGIEIM	VB
LPJR	VB
NFR	NNP
NFQ	NN
TRCH	VB
JIBH	NN
JIBM	NN
HTQFRWIWT	NN
AHBTW	NN
IWQRTIT	JJ
LHSIG	VB
905	CD
TRNGWL	NNT
PRIMAQWB	NNP
AWZLT	NNT
FIFIM	CD
HTNHL	VB
FWPJIM	NN
LHSIQ	VB
LHSIR	VB
AZRXI	NNT
MIWXDT	JJ
DMWQRJIZCIH	NN
MERBIT	JJ
DRFW	VB
MWRJWRIWM	NN
TLWTN	NN
AZWR	NN
PRIFTW	NN
MQSIMWM	NN
PRIFTM	NN
DRFH	NN
LEQWB	VB
NIAWTW	VB
FJWXWT	RB
NDWN	VB
HSBRTI	VB
RQMH	NN
XQIRTW	NN
ZENIN	NNP
IITN	VB
MXFIBIM	VB
LEWLMIM	RB
XQIRTM	NN
RQMT	NNT
RQMW	VB
MAWKZBIM	JJ
IWPIEW	VB
BWAW	NN
LJPL	VB
LTT	VB
FMW	NN
GZENWT	NN
FMN	NN
FMM	NN
FMJ	VB
FMH	NN
FMF	NN
CLSI	NNP
FJRWT	NN
FME	VB
BWAN	NN
MIGWWN	NN
BWAM	NN
FLFWT	NN
TZMWN	NN
IWPQD	VB
BIJLH	VB
MWSLMIM	NN
TQWPH	NN
MWJIB	NN
TQWPT	NNT
DRKI	NNT
FLILIWT	JJ
BIJLW	VB
TARIM	NN
DRKH	NN
TARIK	NN
JWJLIJRIWT	NN
MWSLMIT	JJ
LFMWR	VB
TMWHH	JJ
JBEIWT	JJ
PIIGINS	NNP
REIITW	NN
LHARIK	VB
HQNTH	VB
LIFUJ	NN
TIMHWN	NN
AWMRW	VB
AWMRT	VB
KHNH	RB
LEIIN	VB
PRWZH	NN
HTMQDW	VB
MFWBCT	VB
HEMSH	NN
HTLMDH	VB
TKNNTM	VB
HTAKZBW	VB
EIRNI	JJ
MAWXDT	JJ
MQPID	VB
IBFH	NN
SIEH	NN
JPXH	VB
XWAN	NNP
LBWFH	JJ
IBFT	NNT
EIRNW	NN
IEILWTW	NN
IWBL	NNP
HRCXW	NN
REIWNW	NN
LHRXIQ	VB
MJRTN	NN
MTWQN	JJ
JQSIT	JJ
JQSIW	NN
FBBIT	NN
LWXCIM	VB
LHRXIB	VB
NCIB	NNT
JIRGWBISJH	NNP
KIMIH	NN
CWBR	VB
MTKWWNT	VB
MGIBWT	VB
PWRMJ	NN
BQIAIH	NN
IXWDIT	JJ
LHTBWNN	VB
NIKR	JJ
MKNIQH	NN
MTQNIM	VB
LEFWT	VB
JNIS	NN
AINJLQJWALIM	NN
ZNB	NN
MRXQIM	NN
LKWDH	JJ
ECMIT	JJ
ZWRX	VB
AIDH	NNP
GAWWRILWB	NNP
PSJWRLI	JJ
MGIRWT	NN
ECMIM	NN
24	CD
25	CD
26	CD
27	CD
20	CD
21	CD
MSIBT	NNT
KAMWR	RB
MWQLD	VB
29	CD
TTBE	VB
NQFR	VB
CKWB	NNP
PRWPWRCIH	NN
PWJNCIAL	NN
TXILTH	NN
MAMRW	NN
XWSKIM	NN
PWMBIWT	JJ
HRXBT	NNT
FIIKWT	VB
HTARGNW	VB
MHSS	VB
MBXINIM	VB
TXILT	NNT
PWLXN	NN
HNXIH	NN
HTARGNH	VB
PWLIWWINIL	NN
GRWSBWRD	NNP
IWZMIM	VB
HTRIEW	VB
MEQB	NN
DABL	NN
HFTTPWT	NNT
EBRIIN	NN
KDWRMIM	NN
ICLIX	VB
MBWJLIM	JJ
AILIH	NNP
MIWFNWT	JJ
NINWXH	JJ
REIWN	NN
PRXH	VB
HSBIR	VB
MXMWD	NNP
NKBDIM	JJ
MQRIN	VB
HWDTH	VB
LXDWR	VB
XLL	NNT
MWRALI	JJ
PIISL	NNP
XLH	VB
QAWNJI	NNP
XLF	JJ
XIIHM	NN
XLD	NNP
DIIRI	NNT
XLB	NN
MWDBQWT	VB
EWRKT	NNT
LLQQ	VB
MAFIMIM	VB
XLW	VB
MQRIT	JJ
LTMID	RB
APSWTW	NN
XLQ	NN
XLP	VB
DIPNDRH	NNP
PRWSPR	NNP
NEFIT	VB
LNCX	VB
BDIEBD	RB
NPFWTIHM	NN
NEFIM	VB
FERWRIIH	NN
HFQIH	NN
1.73	CD
SMNJI	JJ
MWEMDI	NNT
QBCN	NN
RMLH	NNP
MAWFPZIM	VB
LNCL	VB
EM	IN
HXZIQ	VB
HXZIR	VB
ED	IN
NPILH	NN
EC	NN
HWDEWTIW	NN
BIUL	JJ
RWXBH	NN
AXRWNIM	JJ
EZ	JJ
IBGWD	VB
ET	NN
HPIKTH	NN
NWIHAWZR	NNP
LRKFW	VB
NASR	VB
AMIL	NNP
NWTN	VB
XLIPI	JJ
AMID	JJ
RIGLH	VB
EZRTM	NN
EZRTN	NN
NWTX	VB
HWKXFW	VB
MFBFWT	VB
NWTQ	VB
MXILH	NN
AMIS	NNP
NWTR	VB
MBWKH	NN
MRKZIWTW	NN
GIRWFM	NN
TPFW	VB
LHWWT	VB
MILWWQI	NNP
LMHDRIN	MOD
AQJIWWIWT	NN
SIAWL	NNP
DWAR	NN
MKWT	NN
GNBW	VB
LXLC	VB
180	CD
MKWN	NNT
GNBH	NNP
TWKNIT	NN
LXLQ	VB
GRBR	NNP
GPRI	NNP
XI	VB
XN	NN
HWLND	NNP
HKNWT	NN
SNIGWRW	NN
MWCRIW	NN
XPIM	NN
XF	VB
XG	NNT
XD	MOD
XWQIM	NN
NWSXH	NN
MWCRIM	NN
HPNR	NNP
XWQIW	NN
XWQIT	JJ
PILIPS	NNP
PDRALIT	JJ
IAKJWT	NN
XWNWT	JJ
HQCNH	NN
MTWNIM	JJ
XIPAIM	NN
HJIP	VB
HSTIIGH	VB
DMIWNI	JJ
DMIWNH	NN
IWBJX	VB
MWXWT	NN
BHLH	NN
FIKWN	NN
MEWLPIM	JJ
MSWPR	VB
MSWPQ	VB
SMIRH	NNP
FGRH	NN
MFPXH	NN
SPNSR	NNP
JWEN	VB
GRPWJQ	NN
MFPXT	NNT
NKSIM	NN
APRIQH	NNP
NTBET	NN
EIWWT	NN
SKNT	NNT
SIWWG	NN
FWHIM	VB
MSWPI	NNT
MWCDQ	JJ
IKWLWT	VB
KRIS	NNP
ALSJR	NNP
4591	CD
ECRTI	VB
PXWT	RBR
NXFPT	VB
LHIFAR	VB
NNIX	VB
MTBRR	VB
RPI	NNP
AWLIMPIH	NNP
IWKNS	VB
FPXT	NNT
MAPIH	NN
MFWXRRT	JJ
LIIEL	VB
QLINQR	NNP
XMQW	VB
EDIPWIWT	NN
HLWK	NNT
HXL	VB
MTKWNT	NN
MPRNS	VB
QRMLIN	NNP
HFERH	NN
MFTXRRWT	VB
ITKNSW	VB
FIBX	VB
ELILH	NN
LWMR	VB
HQLWT	NN
LMXWQ	VB
APLIIT	NNT
MWPIEH	VB
FIBA	NNP
IFRALI	JJ
IFIRWT	RB
ISD	VB
ZLZWL	NN
MRWBI	JJT
MRWBH	JJ
HWDIT	JJ
NWDEH	VB
AILWLA	IN
FPTIIM	NN
HIWTW	AUX
SGWL	NN
SNIP	NN
SGWR	JJ
MQCWEIT	JJ
HWDIE	VB
HRWF	NNP
APIDMIWLWGIH	NN
NJIIH	NN
NDXW	VB
NAWMI	NNT
MWPRKT	JJ
EMMIT	JJ
IWM	NNT
211	CD
WWEDT	NNT
FITWP	NNT
IWCIA	VB
ANGLW	JJ
RCWPIM	JJ
8	CD
HFTRBB	VB
NIDWN	VB
FXITWT	NN
MDWBR	VB
TPWCTH	NN
PERIM	NN
FIIKIM	JJ
AWBRWN	NNP
IMCA	VB
IFUE	NNP
BLIMT	NNT
LHQJIN	VB
HCGH	NN
QBLWT	NNT
NFRW	VB
HCGT	NNT
MLWKH	NN
MWPTET	VB
AMRIQH	NNP
XWWIWT	NN
IRAW	VB
PLIFH	NN
KIHNTI	VB
HCEWT	NNT
MRGFIM	VB
HFTIIKW	VB
HPIQH	VB
HTPRC	VB
XWPFTM	NN
RGFWTIHM	NN
BIILIN	NNP
CIRIM	NN
NRXBIM	JJ
BRZILI	NNP
PIIBWRIJIT	JJ
GBWL	NN
QIBWC	NN
900,000	CD
MHMR	VB
SKR	NN
RXBT	NNT
MJPL	VB
HRAW	VB
MWDIEINI	JJ
IEMDW	VB
SIPWR	NN
XRDI	JJ
RXBH	NN
RXBI	NNT
HWPETW	NN
SIPWX	NN
HGIFW	VB
SIWMW	NN
161351	CD
MFA	NN
MFB	NNT
PWJRIM	VB
CBIWN	NN
TZKH	VB
MFH	NNP
MFI	NN
HADRTW	NN
MFK	NNT
HTBWNNWT	NN
MFM	RB
MCWPH	JJT
RWBH	NNT
MFQ	NN
PSIKIAJRIWT	JJ
HISS	VB
MEBIRH	VB
HNZILT	ZVL
PNIIT	NNT
AISLAM	NNP
ETIDIM	VB
XWBT	NNT
LKIF	NNP
MXQ	VB
SWBL	VB
XWBH	NN
DDI	NNP
MNGNWN	NN
MABDIM	VB
ETIDIT	JJ
TIAWLWGIM	NN
IXWF	VB
TWFIIH	NN
MERBIIM	JJ
JRIJWRIALI	JJ
JILPNW	VB
BWBWT	NN
NBXRWT	NN
KLKLIWT	JJ
DWRFI	NNT
HISJRIH	NN
MFMET	NN
IPGMW	VB
HXKIRH	VB
LXIWT	VB
7191	CD
TXIIB	VB
MXUJ	NNT
MFIMWT	NN
MTKNNIM	VB
DWRFT	VB
ICIRWT	NNT
TXIIH	NN
EWLH	NN
EWLI	NNT
KTLIW	NN
EWLM	NN
RPSWDH	NN
MXWLQT	VB
HFTMFW	VB
NMAS	VB
TWLFWT	VB
FLIJH	NN
LSGL	VB
MNHIGWTW	NN
TMHWNI	NNT
AFTI	NN
ATGRI	NNT
NSIBWT	NN
KDI	IN
PLFTINI	JJ
KBWDW	NN
MQRH	NN
XFBW	VB
MQRI	NNT
KBWDM	NN
MBIE	VB
PWGIMWRI	NNP
LHKLIL	VB
LIBRLIM	NN
AWRXN	NN
HSLJIIN	NNP
SCINT	NNT
IGNH	VB
MQCWEN	NN
MQCWEI	JJ
LSGT	VB
MXMMT	VB
MQWMN	NN
MERKH	NN
CQIM	NN
PRNSIS	NNP
QWBNJRI	NNP
QARIIRH	NN
CIJJ	VB
AWPIINIT	JJ
MERKT	NNT
SPRDIT	NN
NDP	VB
MQCWEW	NN
BWXRIM	NN
965	CD
NDRFIM	VB
AILWZ	NNP
MIIGE	JJ
XWMRH	NN
FNWN	JJ
PNIIH	NN
TWPSIM	VB
MARXIM	NN
XWMRT	NNT
HBJIXW	VB
BJX	RB
HERKTM	NN
EWBDIW	NN
XRIP	JJ
LAWJMN	NNP
DRWWIF	NNP
GPRIS	NNP
PLAFWB	NNP
ARWXH	NN
TIFME	VB
AIPFRW	VB
EKFWWIT	JJ
AWNQIIH	NN
MINWIW	NN
EWBDIH	NNP
ARCH	RB
ARCI	JJ
EWBDIM	NN
MWTNWT	VB
BGLL	IN
MFKNTAWT	NN
IIRD	VB
DWBRWBINCQI	NNP
RMSW	VB
QWBLSQI	NNP
GANDI	NNP
FRPH	NN
NTWNIM	NN
MJILH	VB
MTGBF	JJ
HRCBRG	NNP
IFLMW	VB
MWGBRT	JJ
FNIAWR	NNP
HFLJT	NNT
BWGR	NNT
FBEW	VB
GDRWT	NN
LNSBWRI	NNP
MBIEIM	VB
MWXM	NN
MWXN	NN
FBEH	CD
RGLIHM	NN
14.3.89	CD
BHTIIXSWT	IN
DWGMH	NN
BWRMZIM	JJ
IKHN	VB
HIINRIK	NNP
DWGMA	NN
SGNWN	NN
EBWDT	NNT
HWAIL	IN
MGALWMAN	JJ
EBWDH	NN
MQRNIM	NN
GGWT	NN
HXLIJH	VB
PJR	VB
DWGMT	NNT
LXWF	VB
HWMWRISJ	NN
MFQIEIM	NN
XWQRIM	NN
MGMT	NNT
HEMQT	NNT
XWQRIW	NN
LHTNHG	VB
SMPDWRIH	NNP
SLPSJIQ	NNP
MXLQWT	NN
HINW	AGR
BJXWN	NN
QBILIM	JJ
NPQD	VB
FINNW	VB
BRIKT	NNT
THLIKI	NNT
KRKIM	NN
BDIXH	NN
SIKWM	NN
HINH	AGR
CMXW	VB
XINWKW	NN
EWTMNIT	JJ
GWRMIM	NN
PXWTWT	JJT
AXIHM	NN
BNZN	NN
MQHIIL	NNP
TQWPTW	NN
MWPRK	JJ
PWRJLND	NNP
MRCH	VB
AMWRH	VB
XINWKM	NN
FRIQT	NNT
MWQEWT	VB
AZWRI	NNT
NIMH	NN
HTBLBL	VB
GWDWNWB	NNP
MIXFWB	NN
KIFWRIM	NN
AWPRJIWWIM	JJ
KIFWRIW	NN
QANCLR	NN
ZMIR	NNP
AWPRJIWWIT	JJ
ABHR	NNP
PXDH	VB
DMQH	NN
PNIMH	RB
JIB	NNT
QJEIM	NN
MQRIWT	NN
XLPW	VB
CNWEWT	JJ
KRMWN	NNP
FWWQIM	NN
MMWRMRIM	JJ
EIMWTIM	NN
MEIRH	VB
HTPZRW	VB
MWRAL	NN
MTELMIM	VB
MZGN	NN
ZKIH	NN
QRICR	NNP
HLIKTK	NN
SERT	NNT
FRIMPS	NN
HFMIE	VB
FIKL	VB
MCIL	VB
TIMNE	VB
HCITH	VB
MXQRIM	NN
QWNI	NNT
MCIG	VB
EGWMH	JJ
MCIE	VB
IRQWNI	NNP
LHRKIB	VB
MWQDF	VB
MHIRWT	NN
NECRW	VB
BIJXWN	NN
IRIBIM	NN
KDWRSLNI	NNT
SERH	NN
PLWR	NNP
LXLWJIN	MOD
XMLH	NN
ISRBW	VB
301	CD
LHIKFL	VB
HWTIRW	VB
BWEWT	NN
FARIM	NN
LHSTKN	VB
HWTIRH	VB
RIKWZIIM	JJ
GWDL	NNT
TWAR	NN
RPWBLIQWT	NN
CPWIH	JJ
HTIIBFWT	NN
HWCANW	VB
MCIIR	VB
BNWI	VB
TIWWK	NN
ANDWQRINWLWGI	JJ
TGFIM	VB
SJRIQ	NNP
TLMIDIM	NN
NEBWD	VB
BNWX	RB
MIFWRIM	NN
LWBF	VB
FWJRIM	NN
SJRIJ	NNP
PINTH	VB
BNWT	NN
RFAI	VB
XNQ	NN
LEQR	VB
TGWBTH	NN
QARPIW	NNP
MXBRIM	NN
MXMIRWT	JJ
MSWLSLWT	JJ
MILA	VB
MGPIIM	NN
RGEI	NNT
IWBNJWS	NNP
HKILH	VB
RDWMH	JJ
IPANIT	JJ
TGWBTW	NN
IIDIF	NN
XNN	NNP
MWWTRT	VB
LKH	NN
HTMWJJ	VB
KIBWI	NNT
MITIT	JJ
KIBWD	NNT
QRIIRH	NN
LGWR	VB
ESISIT	JJ
PNIMI	JJ
LEZWR	VB
ARWXWT	NN
HBLJT	NNT
HIFGIM	NN
FLP	VB
TFKIL	VB
CBEWNIWT	JJ
MBED	IN
ZABI	NNP
MSWKNT	JJ
HBQEH	NN
LXZWT	VB
NGRSH	VB
QWMWT	NN
NMCAW	VB
MMTIN	VB
TWSPT	NNT
PWNQCIWT	NN
SINIWT	JJ
MSWRTIT	JJ
MMLKH	NN
HZDMNWIWT	NN
HDWRH	JJ
QCRIM	JJ
BRXH	VB
NWRH	VB
NWRA	JJ
MDWR	NN
AGWDT	NNT
AGWDH	NN
XBLTW	NN
SGIRTM	NN
FWALIM	VB
MDWE	QW
AIFWRW	NN
HEMIDH	VB
MFTTPI	NNT
GQIL	NNP
SMJAWT	NNT
NWRMLIWT	JJ
PEMIIM	RB
IIHNW	VB
IIHNH	VB
HTMWJJWTH	NN
PCEIHM	NN
BRIXT	NNT
AIXWDH	NN
PQWE	NNT
NXJPT	VB
SIBWLT	NN
LXNK	VB
TXL	VB
JLWWIZIWNIIM	JJ
NZQQT	VB
MWJIWWBCIH	NN
IWQRH	NN
IWQRN	VB
LHTPTWT	VB
XIILWT	NN
NXBJ	VB
ZDWNI	JJ
NXBL	VB
PTRWNWT	NN
TXT	IN
MTMWDDIM	NN
HWRTH	VB
CIRIH	NN
MLKWDT	NN
TCWRP	VB
MFWWQ	VB
KPLIIM	NN
PZIZIM	JJ
XWNIM	JJ
NWFNH	JJ
ALPWNSW	NNP
KPIIM	NN
MTQIIMIM	VB
MNWKH	VB
TEWPH	NN
IIBWF	NN
IIBWA	NNT
IIFMEW	VB
GIBWR	NN
NXFWL	NNT
QMPSINWS	NNP
HTRFMTI	VB
NICIM	NN
HTGIIS	VB
WWIFI	NNP
MNHIG	NN
RGFIT	JJ
AXZWR	VB
FNH	NN
MNWKR	JJ
MWXIM	VB
GIBWF	NNT
BGDAD	NNP
NRQMH	VB
LWXWT	NNT
BWRMH	NNP
MSWRT	NN
MRXBI	NNT
MIKL	NNP
FIEIT	JJ
ZQN	NN
FQWL	VB
AIIMN	NNP
TQNI	NNT
TQNH	VB
LHPIC	VB
HIELMW	NN
SWGW	NN
HXZRIM	NN
RJRWAQJIWWIT	JJ
RWMLIH	NNP
FWRFIM	NN
MTNGDIM	VB
LIBRLIT	NN
XDINJWB	NNP
EFITI	VB
JWRX	VB
XWRMH	NN
ABWTI	NN
IWFLM	VB
DQIRT	NNT
HWLEJW	VB
MLWNAWT	NN
SWCIALIT	JJ
FWQXTN	NNP
WWCRNAIH	NNP
HQFR	NN
TWRNWIWT	NN
LHRFWT	VB
NTX	NN
NFMEW	VB
QILWMJRIM	NN
SWDAN	NNP
NFMET	VB
BGDR	IN
WRH	NNP
MWEMDWTM	NN
MKXIF	VB
WRP	NNP
MFRDW	NN
HERWT	NNT
MWSRIT	JJ
LRENN	VB
MAPFRWT	VB
NIMWQ	NN
CBIET	NNT
NIMWS	NN
ALI	IN
7.0	CD
ISIIE	VB
LHQT	NNT
QWLQJIWWISJIWT	JJ
MEJPH	NN
PSWLT	NNT
AWPJIMIWT	NN
LHQL	VB
AWBD	JJ
QBWEIM	JJ
GIWRA	NNP
EJIW	NN
LHIFMR	VB
QABRRH	NNP
PCEW	VB
JENTW	NN
IITKN	VB
MIMF	VB
MILIMJR	NN
JENTN	NN
BLMIM	NN
LIPMN	NNP
JENTH	NN
PCEH	VB
PCEI	NNT
EJIH	NNP
NDMIT	VB
BICEW	VB
SWSIIDAD	NNP
QBLNIM	NN
LBCE	VB
IUD	JJ
MZIQ	JJ
CBEH	VB
MWFLMWT	VB
LHFMID	VB
DBRIHM	NN
NWSKIM	VB
HXJIA	VB
LCWWT	VB
PWNQCIWNLIIM	JJ
442	CD
MCBIEWT	VB
MARS	NNP
ECMAI	JJ
HCIB	VB
FWEL	NN
NZRQW	VB
FTI	CDT
TIAJRWN	NN
8691	CD
IMFIKW	VB
BLFR	NNP
MEWRRT	VB
AGRIGANJW	NNP
PTWRH	JJ
HQJIN	VB
TWPIM	NN
33	CD
32	CD
31	CD
30	CD
37	CD
36	CD
34	CD
MQBIL	VB
PNXSI	NNP
HDGFTI	VB
ALP	CD
IENIQ	VB
HTPLL	VB
QLASIWT	JJ
TBWSWT	NN
NQNS	VB
FQ	NN
FR	NNT
LFBC	VB
TLWNTM	NN
LHIWWKX	VB
ABJLH	NN
MLMDWT	VB
CIDDW	VB
NEDR	JJT
MWLBI	NNP
FXIQT	NNT
BILIWNI	CDT
FB	VB
FAPTNIT	JJ
SMK	NNT
FF	CD
MGP	NN
FI	NNP
LNWKX	IN
FL	POS
FM	RB
QWPMN	NNP
KRKRH	NN
ALXIAT	NNP
JRWPIT	JJ
XJAW	NN
IZRMW	VB
MTRFMIM	VB
WWLF	NNP
RCTH	VB
MDD	NN
MDE	NNT
PLPLIM	NN
HIQP	NN
TPIFTW	NN
MDGIFIM	VB
JWPLH	VB
WWLS	NN
WWLP	NNP
QWLANWBIC	NNP
AWIBINW	NN
MFTWQQ	VB
PRIIM	NNP
TSKWL	NN
ARWJIWT	JJ
MPGINWT	NN
HSTWBB	VB
BQFWT	NN
FRWIIM	VB
PWRNWGRAPIIM	JJ
DMWNIT	JJ
DWMARS	NNP
SWRIIM	JJ
PEWJ	JJ
ILMD	VB
XRIPWT	NN
JEN	VB
DWLQWT	VB
HWRAT	NNT
MXWZ	NN
HRPIH	NN
LHRIC	VB
ANRIQW	NNP
LHRIM	VB
QWMIQAI	NN
840	CD
21PLIWN	ZVL
KWKBIM	NN
5791	CD
ANRIQH	NNP
HPSID	VB
LHRIX	VB
MCJIIRT	VB
HPQT	NNT
EWNT	NNT
AFRW	NN
AFRT	NNT
BXWRIM	NN
CRWRH	JJ
XSWMH	JJ
EWNG	NN
ALMWNIM	NN
FLILI	JJ
MITH	NN
ABIBI	JJ
EWTQIM	NN
PWRJSMWT	NNP
EWNH	NN
LINDAW	NNP
MSRIM	NN
KBIF	NNT
HSGR	NN
IWJH	NN
NMCA	VB
REH	NN
EIRWNIT	JJ
EFIIT	NNT
EFIIH	NN
MFTP	VB
WIZL	NNP
AMBWLNS	NN
MTMID	RB
WIZH	NNP
SWTRT	VB
MINAI	NNP
KFM	IN
LGIJIMCIH	NN
ABA	NN
ASJRAJGIWT	JJ
EIQFT	JJ
MFWLBT	JJ
HTLWNNW	VB
RAFWTW	NN
FMIRH	NN
HGW	VB
MWGDL	JJ
EWLMIT	JJ
ABN	NN
ABQ	NN
ABR	NNT
RIIK	NNP
EWLMIM	NN
ABW	NNP
HTLWNNH	VB
FMIRT	NNT
RXWQH	JJ
BAWAR	NNP
TWGF	VB
PRCI	NNT
PRCH	VB
MTMRMRIM	VB
HIW	AUX
HTRXQWT	NN
HFWWAH	NN
NMSRT	VB
NMSRW	VB
TFWAH	NN
ITQIIMW	VB
PFWJIM	JJ
TIQW	NNT
MHWTIT	JJ
CMDIM	NN
PRCW	VB
BFWRTH	NN
MTXRH	NN
QWSMJI	JJ
NQBEW	VB
AIDIAWLWGIWT	NN
AWLPN	NN
KIWWNH	VB
KIWWNI	NNT
LWQXT	VB
PLILIWT	JJ
NQBEH	VB
IIDRS	VB
TLWNH	NN
HDPSIM	NN
ARAL	NNP
ZWLT	NN
REL	NN
THLIK	NNT
HWPNH	VB
QWWINS	NNP
BWQEWT	VB
TQBL	VB
MWNARKIH	NN
FABWRH	NNP
HNPLD	NNP
SPSL	NN
34.90	CD
MTGBFT	VB
FRRH	VB
SMKWIWTIW	NN
MSEDWT	NN
HKREH	NN
IBJIX	VB
SPINH	NN
MENIIN	JJ
MWZR	NN
MWTRT	VB
KRIZMJIT	JJ
AIDIALIM	NN
PSIKWLWGI	JJ
NGDIT	JJ
NHIGH	NN
MWDRNIWT	JJ
LPI	IN
SPINT	NNT
BAJINIWL	NNP
HKRET	NNT
HBISH	VB
FIER	NN
PWLJ	VB
PWLF	VB
MJWPLIM	NN
HIMLAIH	NNP
BWER	JJ
HTRXFH	VB
HWKIXT	VB
TFLX	VB
BWEZ	NNP
PWLQ	NNP
PRJIZN	NNP
AXWTW	NN
3,000	CD
GIISWT	NN
HGBIRH	VB
QWNGRS	NN
LHTPRQ	VB
PQWDH	NN
ABRDIN	NNP
NIKRT	JJ
EIMWT	NN
NIKRH	VB
MXRWZWT	NNT
ABIBIWT	NN
ICJRPW	VB
QBWEH	JJ
PRWZAQ	NNP
HGBIRW	VB
HZKIR	VB
LFLWX	VB
KWBD	NN
LCJJ	VB
KWBF	VB
AHWB	NN
GMCI	NNP
TSTIIM	VB
MWPNH	VB
BIWRWQRJIM	NN
IWNS	NNP
CMCWMIM	NN
HILT	NNT
MWGNWT	JJ
HILH	NN
IWNH	NNP
IWNI	NNP
HFTWQQTI	VB
RAWBN	NNP
QIWW	VB
TQIPWT	NN
SBRW	VB
411	CD
IXIDI	JJ
IXIDH	NN
MILWWL	NNP
IWHAN	NNP
DRWM	NN
581	CD
BWCEW	VB
ALWPIM	NN
IELH	VB
MRAH	NN
HTMXTH	VB
MRAF	RB
FBETIIM	MOD
HTNHLW	VB
IXIDT	NNT
5405	CD
HTARGNWT	NN
1430	CD
GLED	NNP
MWXFIT	JJ
DMWT	NN
FINWIIM	NN
AMSLM	NNP
ENQI	JJ
DMWI	JJT
GWERT	VB
ITXRW	VB
HWRXQ	VB
HJPH	NN
PIFWJ	NNT
FIKNE	VB
BWLWNIH	NNP
NWJFIM	VB
LHNFIM	VB
MCWRPIM	VB
PEILIM	NN
2,000	CD
HKRH	NN
XDIFH	JJ
2,004	CD
HKRT	NNT
SMKWTIWT	NN
MTNKLIM	VB
ILMDW	VB
AXRIWT	NN
FQIDTW	NN
SNDLR	NN
HKRX	NN
LIDH	NN
HCEH	NN
EWLBIM	JJ
BWLGRIH	NNP
BQFWTIHM	NN
SGWRWT	JJ
QRIAT	NNT
SWBLT	VB
QRIAH	NN
MFJRH	NN
HTAMT	NNT
PAFB	NNP
FIXI	NNT
MZKIRWT	VB
MCDDIM	VB
MWQPA	JJ
PNAWMJIQH	NN
LHTGLGL	VB
ZWHMH	NN
FKWNH	NN
NWRW	VB
MWNET	VB
WRDI	NNP
TWCR	NN
5891	CD
PGIET	NNT
SEWDIIM	JJ
WRDR	NNP
MSPD	NN
MLAKWTIIM	JJ
GWSMN	NNP
FKWNT	NNT
BNIW	NN
PWRIWT	NN
IGIEW	VB
MIDWT	NN
GBW	NN
MJRWT	NN
PXDTI	VB
MKHNIM	VB
MLXMH	NN
NSXRWT	VB
BMAIM	NN
ENPI	NNT
RBBWT	CDT
BNIN	NN
NWBE	VB
AWRLANDW	NNP
PJWR	VB
LBNIM	JJ
EMWQWT	JJ
FIJTH	NN
FIJTI	JJ
IBWANIM	NN
AWLMW	NN
NAWN	NN
NAWM	NN
NIIRWT	NNT
NAWT	NNT
AWMH	NN
NAWR	JJ
BLJMN	NNP
AWLMI	NNT
MHLWMH	NN
HFTIIKWT	NN
ERNWT	NN
496	CD
TTAMT	VB
MSPQ	VB
TRXIQ	VB
IHWDIIM	JJ
HWMWRISJIM	JJ
MQHIL	JJT
FRFRAWT	NN
79.90	CD
LSMN	VB
ANWFIT	JJ
9891	CD
ITWQN	VB
TRXIB	VB
TRXIF	NN
KWNNWIWT	NN
QDIFZWN	NNP
MWDAGIM	JJ
QLWRIWT	NN
ZIQWQ	NN
MTNGD	VB
BJIXWT	NN
LBLBL	VB
HRWWIXW	VB
HTXFB	VB
JRIQ	NNP
XDD	NNP
LQWXWT	NN
JRIZ	NN
NWJINGHAM	NNP
SWBBIM	NN
BNIIN	NNT
HXMCH	NN
ICIRT	NNT
NKLLH	VB
FDRH	NN
IWMRNWT	NN
SQRN	JJ
TGWWE	VB
1,000	CD
NTNIH	NNP
1,005	CD
NWPF	NN
1,008	CD
BRZL	NN
NWPL	VB
ICIRH	NN
BRZI	NNT
MFQIEH	VB
HRXQ	RB
QWRPW	NNP
DMWQRJIT	JJ
LHACIL	VB
HMWMH	JJ
IFPIE	VB
TQWPWTIHM	NN
FWIIC	NNP
HISJWRIIM	JJ
MQFWT	VB
ANDRW	NNP
AMPIRIT	JJ
MZRXI	NNP
KMAL	NNP
NWKXIM	NN
FQSPIR	NNP
MKIWWN	IN
CLLIM	NN
AMWNTH	NN
NWKXIT	JJ
MEPEPIM	VB
TZH	NN
PIGWEI	NNT
ALIMIM	JJ
BLBWL	NN
IQXW	VB
TMHW	VB
IIBXRW	VB
MBCE	NN
TMHR	VB
KRISJINH	NNP
RILQH	NNP
AXIWT	NN
QWAN	NNP
TAPFR	VB
QWNDSI	JJ
BEIITH	NN
PRISH	NN
NGEW	VB
MAGIQ	NNP
BTIHM	NN
AIBDW	VB
MFWTPIM	JJ
IXLW	VB
DETKM	NN
AMRIQNIT	JJ
NIFWAI	NNT
LNXWL	VB
FMRNWT	NN
GLWB	NNP
HKNSH	NN
JBIEWT	NNT
AMWTIHM	NN
HKNST	NNT
QWLW	NN
HERKH	NN
QANARI	NNP
2791	CD
BIDWRIWT	JJ
BIBI	NNP
SRZW	NNP
SMINR	NN
LWAI	NNP
MFEFEWT	JJ
TMIMWT	NN
FWPJI	NNT
AFMH	NN
FWWRDNADZH	NNP
JIIMS	NNP
XNINH	NN
MNDLMN	NNP
IDRFW	VB
FWPJT	NN
DQWR	NNP
GMIFIM	JJ
36.4	CD
AFMX	VB
MDGIFH	VB
BWRSH	NN
RATH	VB
MTNGDWT	VB
PWLNSQI	NNP
MCWJJIM	VB
LHFQIE	VB
NWHRIM	VB
FNTIT	JJ
TQLH	NN
HFTTPW	VB
HPSDI	NNT
PFRNIM	NN
KRML	NNP
IIFMRW	VB
HJEIM	VB
NIIJLIIN	NNP
PIQWDI	JJ
HTNGDWTM	NN
AIID	NNP
ERWC	NN
HTBRR	VB
AIIM	VB
HKNSWT	NN
NABQWT	VB
S	NNP
GNFR	NNP
MKST	NNT
AFLIWT	NN
RWBRJW	NNP
IIDRFW	VB
PIQWDW	NN
HQFIB	VB
RWBRJS	NNP
DISQWJQIM	NN
PIRWJ	NNT
AFP	NNT
PLFTIN	NNP
LZRZ	VB
HTNGDWTW	NN
LASWP	VB
AWPIH	NN
SMNKUL	NNT
IWRFW	VB
TKFIJ	NN
HMFKIM	NN
HTXIIBTI	VB
XIZWQH	NN
MABQ	NN
IFMRW	VB
AZI	RB
MTNH	NN
CMRT	NNT
XIZWQIM	NN
AWRIAL	NNP
XTWNWT	NN
GWLIANW	NNP
PRWSWT	NN
GBBH	NN
38.27	CD
MTMQDT	VB
XIZWQW	NN
LARWB	VB
NGRMH	VB
DXWPIM	JJ
HWFLK	VB
QRAH	VB
SGIRH	NN
MXRT	NN
SGIRT	NNT
TTAPFR	VB
SJRWISQI	NNP
QRAW	VB
QRAT	VB
KAILW	IN
ALMLIX	NNP
XIQH	VB
ITPTX	VB
HJBIE	VB
NTQE	VB
QIIZR	NNP
EZRA	NNP
ZWWIT	NN
LIQJ	VB
LHSDIR	VB
EZRH	NN
461	CD
EZRN	NNP
HITR	NN
SMINRIM	NN
MTRXFT	VB
EZRT	NNT
MZHIRH	VB
IQR	JJ
NXNK	VB
ITWSPW	VB
MGWG	NNP
NITNH	VB
LSIIE	VB
DXIPWT	NN
BIJWI	NN
LRAWT	VB
BIJWN	NNP
LSIIM	VB
AIFAM	NNP
XFMLIT	JJ
MDWIQWT	JJ
MBWLBLIM	JJ
NITNT	VB
LBN	JJ
AWQIINWS	NN
QWNCRJIM	NN
HTELH	VB
FXQNI	NNT
GRWZLM	NNP
MXQH	VB
JARAN	NNP
EFTWNWTIW	NN
MDAIG	VB
MCWQTH	NN
ICRI	NNT
MCWQTN	NN
ZIMWN	NN
MCWQTM	NN
25.11	CD
MLBI	NNT
LFKNE	VB
XWD	NN
TWTXNIM	NN
42.02	CD
HIWM	RB
MBJ	NN
MQCWEIIM	JJ
XWB	NN
TWFBIH	NN
AIDIALISJIM	JJ
NEFH	VB
GAQ	NNP
988891	CD
MMFLTIT	JJ
GAN	NN
NEFW	VB
ADWMIM	NN
JKNI	JJ
GAH	VB
KFLWNWT	NN
RWCWT	VB
LHMJIR	VB
GAD	NNP
HIWT	IN
MFQWLWT	NN
TRMIT	NN
HIWW	AUX
FTIHN	PRP
PWTXT	VB
MMWXZR	JJ
ISTIIM	VB
ITBE	VB
MHGRWT	NN
MWPNM	JJ
HFART	NNT
JKNIQWT	NN
ZKIITW	NN
AFMTM	NN
IHWFPJ	NNP
MQSM	NNT
IWTNW	VB
NECR	VB
FDRT	NNT
027	CD
NRAW	VB
IISDW	VB
GNWAH	NNP
LFGR	VB
021	CD
MBWQFT	JJ
CPWNIT	RB
MWDIM	VB
IBZBZ	VB
FMINIT	JJ
FLJH	VB
ETQ	NN
CNCNT	NNT
NZEQW	VB
AMBIWWLNJIIM	JJ
AZLM	NNP
MBWQFIM	JJ
BIQWRWT	NNT
TQIPH	NN
QII	NNP
TNWRIM	NN
LHTPFR	VB
NEWRIM	NN
HAGR	NNP
HSIR	VB
KHW	VB
KHH	JJ
KHN	NNP
AMRTI	VB
HSIE	VB
MFJRTIT	JJ
QIQ	NNP
QIR	NN
CPWPH	JJ
HSTKMW	VB
MTIIXSWT	VB
BAJRWWRT	NNP
IM	NN
ANRGIH	NN
MFRDIHM	NN
PQWDWT	NN
GINWNI	NNT
FIRWTIM	NN
DRBWN	NN
LFQWD	VB
RWLJH	NN
PRISTH	NN
HSTKMH	VB
LFQWL	VB
QWNPDRCIH	NN
CINI	JJ
RWCXIM	NN
PINWQ	NN
MEFH	NN
QRBTM	NN
TZRZNH	VB
HIRCW	VB
KWXWTIH	NN
LHIELM	VB
SINMJQ	NNT
RIKZ	VB
NITWXI	NNT
PQIDIM	NN
DIMWI	NN
GALWP	NNP
AMHWT	NN
MQBLWT	VB
ELMIN	NN
INWHLW	VB
KTBT	VB
MBXNM	NN
IWWNIWT	NN
13.00	CD
MBXNH	NN
ARBLI	NNP
SWLIDARIWT	NN
AIMTW	NN
SIBWKIM	NN
IRCH	VB
KTBI	NNT
KTBH	NN
QSJWT	NN
ETH	RB
IZWMH	JJ
RMWT	NN
PDRLIT	JJ
BWXNIM	VB
AWJWNWMIT	JJ
MENIQ	VB
MXWDF	JJ
KINH	VB
IDRF	VB
KINW	VB
HTENGTI	VB
MPWZR	JJ
SPQN	NN
KINS	VB
DRWMIT	JJ
RMWN	NNP
PIQRIH	NNP
NBEH	VB
FIMWF	NN
MHDRIN	NN
LXFWP	VB
BKIIH	NN
NIQWSIH	NNP
XWLCWT	NN
AWLIMPIADWT	NN
HTQIM	VB
XIFWQIM	NN
51P6ARBEIM	ZVL
EWD	RB
EWZ	NNP
MEWNWT	NNT
MEWRERT	JJ
MEWDDIM	VB
DWMIHN	NN
LGLWT	VB
EWR	NN
FPJ	VB
EPUI	IN
MGRFIM	NN
LFAWB	VB
PWNW	VB
SMLIM	NN
FBIJ	NN
IKWLH	VB
IKLW	VB
HRJBT	NNT
AWDWT	IN
PLAJW	NNP
BWDDH	JJ
LFAWL	VB
PRSJ	NNP
MWSWRGSQI	NNP
NPLJH	VB
SMLIW	NN
IKWLT	NN
PWNH	VB
SWTRWT	JJ
HGBILW	VB
HZRMT	NNT
QRLH	NNP
HISJWRIWNIM	NN
ZNWWH	NNP
GWBFH	VB
AXWZH	NN
CXQWQW	NN
GWLDFJIIN	NNP
BLGRAD	NNP
HZRMH	NN
XTIMTW	NN
1986	CD
LENWT	VB
LEWMT	IN
1985	CD
NFART	VB
MFPXTWNIM	NN
209,000	CD
HTMWDDW	VB
1988	CD
ALIEZR	NNP
LENWD	VB
NIDXIM	JJ
EIRIWT	NN
AGWDLIHM	NN
HTQPWT	NN
BGRWT	NN
LHKNIS	VB
HWNGRIH	NNP
IBQFW	VB
CWDQ	VB
GNRAL	NN
TKWWN	VB
LHBIA	VB
CIIT	VB
LHBIN	VB
GWRST	VB
LHBIJ	VB
LNDAW	NNP
IEZRW	VB
MWNXIM	NN
CWINH	VB
HFLMT	NNT
JWRQIIH	JJ
88	CD
JWRQIIM	JJ
KRJST	NNT
MBLIM	VB
DIILIM	NN
89	CD
PLFTINIIM	JJ
HTBDXWT	NN
AWMC	NN
MDGM	NN
NFBRH	VB
PARQIM	NN
ZHW	PRP
CRKIW	NN
MAMCIW	NN
NANXIM	VB
MFMIC	VB
PLAGIAJ	NN
HAMINW	VB
CBEWNIT	JJ
DWKNIM	NN
MAMCIM	NN
ZHB	NN
MSDIR	VB
KWRXH	NN
CWWXIM	VB
CRKIH	NN
ZHH	JJ
CRKIM	NN
DIKPIN	NN
GINGIS	NNP
PRIS	NNP
49	CD
46	CD
47	JJ
44	CD
45	JJ
42	CD
43	CD
DIALWG	NN
41	CD
LMEN	IN
HSDRIM	NN
PRNQPWRJ	NNP
LMEJ	IN
LWPA	NNP
NQLE	VB
MIWED	VB
DNDIQ	NNP
DRIFWTINW	NN
IKWLNW	VB
PNIWTIHN	NN
HTBSSW	VB
SJJWJWRI	JJ
520500	CD
XLQIT	RB
MBJAT	VB
MHDQIM	VB
FTIQH	NN
AISJNBWL	NNP
XLQIM	NN
LPRSM	VB
BIJWL	NNT
GDWDIM	NN
RWBINSWN	NNP
FANDRH	NNP
PRMIWT	NN
ZRQWRIM	NN
MTKNNT	NNT
MQGI	NNP
QWRAIM	VB
LHTEMT	VB
XRWZIM	NN
MNEW	VB
NIMNI	NNP
XWQQH	VB
HAWJWN	NNP
DWGLT	VB
HIQLJWT	NN
GILWII	NNT
EWDPIM	NN
DRMJIT	JJ
LHTQIN	VB
NWGEIM	VB
NILSN	NNP
IWDET	VB
SRJNIIM	JJ
RGIL	JJ
MCRIT	JJ
AQDMIIM	JJ
MDINIIM	JJ
ARCIIM	JJ
LHTRIE	VB
XBR	NN
MCRIM	NNP
CEIRINW	NN
BDQW	VB
XBJ	VB
LHTRIS	VB
QWNJRAS	NNP
HDWQH	JJ
JLWWIZIWNI	JJ
NCIGW	NN
JLPWN	NN
MGNH	VB
BRIWNIM	NN
BQBWQIM	NN
HRQIEW	VB
MFTKR	VB
BIKRW	VB
MZRX	NN
341	CD
HTRGLW	VB
G.	NNP
EMITWTIH	NN
NCIGH	NN
NCIGI	NNT
GW	NNP
MXLQH	NN
BAIWDIH	NNP
HTBWNNH	VB
MCANW	VB
GZ	NN
IREILW	VB
GG	NN
HGINWT	NN
GD	NNP
GB	NN
AMZLG	NNP
HTBWNNW	VB
AFKWL	NNP
GN	NN
MBWGR	JJ
GL	NN
MFTDLT	VB
AZEQT	NNT
MEDIPIM	VB
LIQWII	NNT
MEBDT	VB
HTIIBFW	VB
IEWD	NN
MFRD	NNT
TFMWR	VB
HIMWRI	NNT
NCXWN	NN
TWPRT	VB
JJRI	JJ
MEBDH	NN
DIALWGIM	NN
AZEQH	NN
TGBWR	NNT
GIHAD	NN
TIKTB	VB
LAXWR	MOD
AGRWPW	NN
APFR	VB
NRFMT	VB
NTMKH	VB
FDWLT	NNT
LAXWZ	VB
HCDIQH	VB
MISIM	NN
HTPIISWT	NN
LHRGIE	VB
KWLM	PRP
GZIRWT	NNT
MECBT	VB
MTMXIM	NN
NRFMH	VB
SIDWRIM	NN
BEUM	NN
SWNJH	NN
NMNE	VB
TWGBR	VB
DHWI	JJ
MWBHQ	JJ
SPWGWT	VB
MQFQF	VB
MPLJ	NNP
MPLH	NN
XNWT	NN
DIWWXI	NNT
LEGH	NN
MFPJIT	JJ
ZH	PRP
MTELH	VB
GARI	NNP
IQRWT	JJ
FQWPWT	JJ
GZBRWT	NNT
HWELW	VB
TWRNIM	NN
MTARXT	VB
QBEW	VB
DXWP	JJ
DXWS	JJ
TPQWD	NNT
MAZIN	NN
HKWWNT	NNT
HDPS	NN
NFXQW	VB
ZR	JJ
WRDIGR	NNP
MRGILH	VB
MMFLIM	NN
QILWMJR	NN
HZRIMW	VB
NMNI	NNP
SAWTHPJWN	NNP
QLIJT	NNT
HFTLMWT	NN
MNWWL	JJ
BWGIN	NNP
1,800	CD
HZRIMH	VB
ABRHM	NNP
KPI	IN
MWRKBWT	VB
MWXMD	NNP
MWDAGT	VB
XGIGIT	JJ
BMQRH	RB
PWBIZM	NN
MECMTIT	JJ
IWDE	VB
HFTGEW	VB
MWUP	NN
IDENIM	NN
AGWCNJRI	JJ
LHSTBK	VB
NHIRT	NNT
HTXILW	VB
SPARS	NNP
NXNKW	VB
MTKTF	VB
HFQIEW	VB
XWRIN	NNP
QRIJIIM	JJ
ARGNJINI	JJ
MKSIM	VB
HBIE	VB
LAWMIWTM	NN
LHTARGN	VB
MWDILIANI	NNP
ALH	JJ
TWSST	JJ
IINTN	VB
DBEI	NNP
DWEKWT	VB
QAMP	NNP
MDINI	JJ
BARNS	NNP
RDIWS	NN
MILIARDIM	CD
HWBRR	VB
PLFTINAIIM	JJ
KPWLH	JJ
PIIRW	NNP
SXWJH	JJ
HFTAWT	NN
PCIEH	NN
JKNIQH	NN
XWZRWT	JJ
CBAIWT	JJ
BARNM	NNP
MDINT	NNT
GILMW	VB
IGWR	NNP
NWRWWGI	JJ
AWPRJIWWIWT	JJ
SBIRH	JJ
KLBW	NNP
HTAGDW	VB
LHZEIQ	VB
ECWMH	JJ
PRJIM	NN
ADWLP	NNP
MAIIM	VB
WTIQ	JJ
099891	CD
LFTWQ	VB
EJI	NNP
MSPQWT	VB
ZRWEWT	NNT
GBLS	NNP
JENT	NNT
HPTEWT	NN
JENH	NN
TXZITW	NN
HTELMWT	NN
NDBK	NN
1,509	CD
XFBWNAIT	JJ
XWKMH	NN
NKBF	VB
NKBD	JJ
NWSXT	NNT
IMMF	VB
FXRWRM	NN
XIWT	NNT
LDWN	VB
FXRWRW	NN
QLANMCH	NNP
XIWK	NN
XIWN	NNP
MMWXFB	JJ
IIL	NNP
XIWB	NN
JIL	NN
DIWWX	NN
NFXQ	VB
MFEMMT	JJ
RWMXIM	NN
QRA	VB
HBHIR	VB
FXT	NN
ELWT	NN
FXQ	NNP
FXP	NNP
RZH	JJ
ELWN	NN
ELWL	VB
PIJWRIM	NN
BLBD	MOD
MWTIR	VB
BQFT	NNT
KPWPIM	VB
BQFR	IN
BNIMIN	NNP
FWAL	VB
6.6.82	CD
MILIARD	CD
FWAH	NN
LHKIN	VB
NAWRLWG	NN
KWTBIM	NN
FWAB	VB
XSRWNW	NN
AIBDH	VB
MZIMH	NN
LAIIF	VB
ITLWW	VB
LAIIM	VB
LHKIR	VB
GIRWFIM	NN
FWAP	VB
GIRWFIN	NN
MFQIP	VB
XKIM	NNP
MMCAIM	NN
MMCAIH	NN
10.3	CD
HTERB	VB
GIISNW	VB
MRKIB	NN
MUQ	NN
MRINWB	NNP
ASIPWT	NN
RCPH	NN
QING	NNP
QJLWG	NN
HWEBRW	VB
SAM	NNP
DIBR	VB
SINTJIT	JJ
HSIXH	VB
MQCWEIWT	NN
MTNPX	VB
HFWW	VB
AINNI	RB
400	CD
RWDI	NNP
HWEBRH	VB
XZQIM	NN
MCATI	VB
PRLMNJARIT	JJ
LHCNIE	VB
ETIDWT	VB
AISLAMIM	JJ
MFTQE	VB
INJF	VB
BICEH	VB
HWWH	NN
GBWRWT	NN
JNTM	NN
MILIARDI	CDT
CWRTH	NN
SIXRRH	VB
LBXWR	VB
ALKWHWL	NN
LBXWN	VB
LHWCIA	VB
CWRTW	NN
NXLQIM	VB
DBQ	NN
FPIRA	NNP
DBR	NN
GII.	NNP
LFER	VB
LHFAIR	VB
XLIJ	NNP
QALIARI	NNP
ZKINW	VB
XLIL	NN
EWBR	VB
IQBE	VB
MTQNI	NNT
HPXTT	NNT
MUM	NNT
QIBLNW	VB
NPALIM	NN
QLIM	JJ
NCBEW	VB
SIIRW	VB
SIIRT	NNT
FBIEIT	JJ
IWTIR	VB
QLIE	NN
EWBD	NN
HAFIMH	VB
MFXQ	NN
BADR	NNP
HPXTH	NN
ZWEBI	NNP
10.6	CD
RWWIWT	JJT
XIBWR	NN
BTWK	IN
SWEDIM	NN
TIMWT	NN
MJRH	NN
BTWR	IN
87591	CDT
HKRIEW	VB
MAIIMWT	JJ
MFXH	NN
JIWLIM	NN
WINGIIJ	NNP
AFM	JJ
MWSDIIM	JJ
AFH	NN
KMIHTH	NN
MPNI	IN
AFF	NNP
IEID	VB
PWJNCIALI	JJ
MSWLSLT	JJ
ASP	NNP
MXFBH	NN
NIHWL	NNT
W	CC
AFT	NNT
FMINI	JJ
LHTMCA	VB
MERBH	RB
AFR	REL
REIDT	NNT
MNXM	NNP
ATGR	NN
CIPW	VB
RWZNJL	NNP
QLIPH	NN
MNXF	VB
MFWWH	VB
CBAI	JJ
PJNJ	NN
THLIKIM	NN
NSPGW	VB
ADIFWT	NN
HWRWBIC	NNP
MEDW	VB
EWBRW	NN
XWBRW	VB
BTI	NNT
BTH	NN
HNHLTH	NN
AIMPRIIT	NNT
LHIDXQ	VB
LHEBIR	VB
MFTEMM	VB
LHGMIF	VB
MWPEI	NNT
CLBINSN	NNP
MLIQH	NNP
CIRWPH	NN
TPEWLIT	JJ
yyDOT	yyDOT
IWXZR	VB
NWXWT	JJ
PZGZ	NNP
RBIEI	NNP
MXWBR	VB
HPSIDW	VB
FLIH	NN
IDE	VB
CWXQIM	VB
LPNIM	RB
MWZLIM	JJ
HPSIDH	VB
XRIGH	NN
XWBWTIH	NN
AWMNWT	NNT
LHBLIJ	VB
EUM	NN
XWZQH	NN
IRDNIT	JJ
GWPM	NN
EUI	IN
CRPTIT	JJ
HKRIZ	VB
IIFLX	VB
ZIQNH	NN
MECBWT	JJ
EUC	NNP
TPNIT	NN
BRIAWTI	JJ
BBLI	NNP
HSPIQW	VB
FITWQ	NN
EUP	IN
HEBIRH	VB
EUR	NNP
FBTWT	NN
MFMEI	JJ
DGLIM	NN
LLDT	VB
ELWLIM	VB
QSIRR	NNP
HSTDRWTIT	JJ
SWMAW	VB
2,132	CD
TPIXH	NN
1977	CD
LFRWP	VB
SIJWNAIT	JJ
WWLIH	NNP
FBTWN	NN
FLIJIM	NN
13,095	CD
MFMEW	NN
ITEWRR	VB
HWELH	VB
HBJIXH	VB
QPDN	JJ
BIBLIWGRAPIT	JJ
GFWMH	JJ
FNWA	JJ
IFWBW	VB
MTBGR	JJ
HCJRP	VB
RIMWNI	NNT
KWFI	NN
LXWN	VB
KWFL	JJ
WILIAMS	NNP
QWBEIM	VB
MWPRZ	JJ
AWXNH	NNP
DRIFT	NNT
HWMWRISJI	JJ
FWRWT	NNT
IIPTX	VB
DRIFH	NN
NPTX	VB
MWPRF	VB
HXLIJW	VB
MWPRD	JJ
RPWRMWT	NN
LXWT	NN
KWFR	NNT
AQMH	NN
GWRMT	VB
PLSJIQ	NN
GWDF	NNT
HTWWDE	VB
GWDH	NNP
CWR	NNP
BNGQWQ	NNP
SPWR	NN
GWDW	NN
PWNDMNJLISJIWT	JJ
AWLJIMAJWM	NN
NQSWNH	NNP
MPWTX	JJ
SWPRIM	NN
MXWCH	IN
GWRMI	NNT
NICX	VB
LNWD	VB
ECBNIT	JJ
ZWRXT	VB
HSTGLWT	NN
MSKWT	NN
GIDWLIM	NN
CMWDT	JJT
HIPLJWTM	NN
CMWDH	JJ
NICI	NNT
NICN	NNP
NICL	VB
AFQLWN	NNP
NICB	NN
ITERB	VB
HSTPQH	VB
PITXW	VB
ABRI	NNP
BIWN	NN
XTMH	VB
MQWPXIM	VB
ENTH	VB
JWRS	NNP
HCBIE	VB
NNCX	VB
MSBIR	VB
HWELTH	VB
XTMW	VB
EMDTH	NN
HZDMNWT	NN
GMWRH	JJ
QJRQJ	NN
SWBIIJI	JJ
HWBHL	VB
CDNW	NN
QFMIR	NNP
MIWCR	VB
IRWDH	JJ
AWUMI	JJ
IRWFLIM	NNP
544	CD
QIRWT	NN
NGINTW	NN
HTAIM	VB
QIRWR	NN
HRMWNIH	NN
MFWXRRRIM	JJ
IWJL	VB
AXLMH	NNP
MINTH	VB
FXCNWT	NN
WED	NNT
LHRFIE	VB
PTRWNW	NN
HWCATW	NN
NCXWNW	NN
HWCATI	VB
MQWNN	NNP
LHIKLL	VB
HTKWWC	VB
ZQNIM	JJ
WWTIQ	JJ
CWENIM	NN
MTGWRRIM	VB
IWJR	NNP
QLWWIN	NNP
KF	IN
SWXRI	NNT
ABI	NNP
BWGRT	NNT
KWWNTW	NN
ZILND	NNP
MBWSS	VB
TMFIK	VB
LXTWM	VB
GDLH	NN
KWABIM	VB
RIFWI	NN
XBRI	NNT
HTIIQRW	VB
KWWNTI	NN
KWWNTH	NN
EIQRIT	JJ
NPFW	NN
FNWI	JJ
TWFG	VB
NWQFH	JJ
FWERIM	NN
KN	PRP
IFQIE	VB
GRWZINIM	NN
MEWRBIM	VB
LRGL	IN
EITWNW	NN
WWDQH	NN
FNWT	NNT
MARXT	VB
LARGN	VB
TZWZH	NN
AIRWEIM	NN
HCEID	VB
NFB	VB
GIBRIL	NNP
ICANW	VB
IWCRT	VB
NSEH	VB
JIPWL	NN
XWSIIN	NNP
XDL	VB
LAWMNI	JJ
XDH	JJ
EDKWN	NNT
ACBEWT	NN
XDT	JJT
XDR	NNT
XBRT	NNT
QWMDIH	NN
ABL	CC
BLW	NN
EQBWTIHM	NN
IRIBIHM	NN
BELIHM	NN
LBLWE	VB
EIIRWT	NNT
PDRALIIM	JJ
AGNH	NNP
XBRW	NN
GWDLH	NN
MPTIE	JJ
LBLWM	VB
AWJWBWS	NN
BLS	NNP
LBLWT	VB
HFQETW	NN
RFIWNWT	NN
MTNCL	VB
DRMJIWT	JJ
MWAFMT	JJ
SWD	NN
MEWBD	VB
MWPIEIM	VB
NITWQ	NNT
BLI	IN
NITWX	NN
HTAMCW	VB
RKFW	VB
MRPST	NNT
FIXWTIH	NN
ETID	NN
IAWF	NN
MJEH	JJ
NFP	NNT
MJEN	NN
1.6	CD
TPNH	VB
ZIMND	NNP
NXQRWT	VB
AWTR	VB
067008	CD
LPEMIM	RB
FIXWTIW	NN
TENWGWT	NN
ETIR	JJT
1.1	CD
BILWII	NNT
SJNDRJI	JJ
AWTM	DT
SINIT	JJ
BLA	IN
NAMDIM	VB
XWSKT	VB
AWRTWDWQSI	JJ
TAWZKR	VB
EWWLWT	NN
ABRMSQI	NNP
FIJWTIW	NN
MTSKLT	JJ
LELWT	VB
MLWA	NNT
CRLJWN	NNP
MLWL	NNP
EITWNI	NNT
AISLMIM	JJ
XWWT	NNT
HFPIEW	VB
MLWT	NNT
TFWMT	NNT
TCJRK	VB
PWRMALIT	JJ
QWNCPCIH	NN
SIWE	NN
GALH	NN
GALI	NNP
PIJRH	VB
NWSPT	JJ
NWSPW	VB
IWZMH	NN
HTRXB	VB
HTIIECWT	NN
PJWRIM	VB
NALCT	VB
LHDRIK	VB
KNSIM	NN
IWZMT	NNT
HWENQ	VB
IWDEIM	VB
HTXIIBWIWT	NNT
FIJT	NNT
HWPELW	VB
QWMWNISJIT	JJ
IPANI	JJ
TKKIM	NN
IFAIRW	VB
PWQXT	VB
NRDPT	JJ
MIMD	NN
ANARKIH	NN
MIPGF	NNT
HZKIRW	VB
QWMWNISJIM	NN
AFKNZIM	NN
D	NN
AQRILN	NNP
QRB	NNT
QRE	NN
IIFQ	VB
QRH	VB
QRI	RB
QRN	NN
BIHUD	NN
QRP	NNP
RWBCT	VB
BIHUX	NN
MZIMT	NNT
KBFW	VB
MWEMDIM	NN
BIHUS	NN
IXPWC	VB
BLWMPILD	NNP
yyEXCL	yyEXCL
MDWBRIM	JJ
NXLH	VB
DWID	NNP
HPR	VB
JIMIFWARH	NNP
NXLF	VB
MPNH	VB
HPK	AUX
MERIKH	VB
PSIKW	NNP
IGWRFW	VB
MEWWTT	JJ
KNW	NN
KWLLIM	VB
NXLW	VB
NXLT	NNT
LJEWN	VB
SIGLTI	VB
MQNIM	VB
HNIBH	VB
PSGH	NN
MGWRIHM	NN
GIFWT	NN
HAFMH	NN
MIAWS	NN
LHSKIM	VB
ANJWLIH	NNP
AIJLQIM	JJ
HNIBW	VB
RWWQH	JJ
WWIDWIIM	NN
ARGWNI	NNT
HTKWWN	VB
IWBA	VB
QINGDWM	NNP
MAXWR	MOD
MAFR	IN
ECWTIHM	NN
ZIKIWN	NN
MXIIKIM	VB
TSISH	NN
MWKFR	JJ
HTPJR	VB
MINISJRIALIT	JJ
IIERKW	VB
LHTLQX	VB
MMLKTIIM	JJ
DISQRCIH	NN
KHNISJIM	NN
LHIBNWT	VB
HKXIFH	VB
HLIKH	NN
MSWLPIM	VB
QWMPWZICIH	NN
PRFWT	NN
QWRSIM	NN
1,900	CD
HKXIFW	VB
MRHIBWT	JJ
PNIWT	NN
LHXDIR	VB
MFWWQIM	VB
QDWMIM	NN
LQWX	NN
RXL	NNP
HGIRH	NN
XFAIT	JJ
RXB	JJ
DWQJWRAJ	NN
IRDNW	VB
IQIRIHN	NN
LQWM	VB
BEJW	VB
ALBZ	NNP
LQWI	JJ
NSETI	VB
DMWIWTIW	NN
LFWNI	JJ
MSWGL	VB
RIBWEIM	NN
59	CD
58	CD
SMJH	NN
55	CD
QWBET	VB
57	CD
56	CD
51	CD
50	CD
53	CD
52	CD
FLIF	NN
SNIGWRIHM	NN
PTWXH	JJ
2991	CD
LAWMIIM	JJ
HEBIR	VB
MXMT	IN
JWRAI	NN
WRGAS	NNP
KWNSH	VB
HS	NNP
EQRW	VB
HEMDT	NNT
HEMDH	NN
HN	PRP
PZIH	NNP
HM	PRP
ICR	VB
MXMM	VB
KIHN	VB
MXMJ	NNP
GRILH	NN
RCNW	VB
SGNI	NNT
SWXRIM	NN
HWDIEW	VB
EQRWNWT	NN
TIBT	NNT
NISITI	VB
IWKRE	VB
THIIH	AUX
MNH	VB
EWBIH	NN
HTEWPP	VB
MNK	NN
NHNH	VB
QILW	NN
HWDIEH	VB
NJIFTW	NN
EWNFW	NN
RWCXW	NN
IXZQALI	NNP
MNE	VB
MWMLCIM	VB
MTMJIQH	NN
MRXQ	NNT
MRXP	VB
MHWTI	JJ
AQWLWGI	JJ
TXRIP	VB
MFTTPIM	NN
NISIWNH	NN
ICWIDW	VB
HDGMT	NNT
TLIWN	NN
MPRIDIM	VB
MRXC	NN
857	CD
HWPGNH	VB
MWTQPWT	VB
QRWBI	NNT
QRWBH	JJ
AFKNZI	NN
MHWTW	NN
JENWTIW	NN
TIQWNM	NN
PRWIQJIM	NN
HTMQDWTW	NN
DWDWT	NN
MWDEIM	VB
QINMWN	NN
QJNWT	JJ
THSS	VB
IINTNW	VB
HWQL	VB
SWZI	NNP
MZMIN	VB
BRWMIC	NNP
LHINTN	VB
NZEMT	JJ
MCBRIM	NN
RIIDAAWJ	NNP
LXCIM	NN
036086	CD
NELIIM	NN
RWJCIH	NN
BNQ	NN
QLABRIH	NNP
LHINTQ	VB
MDWWX	VB
NFQP	VB
NMIR	NNP
AIRWEI	NNT
EWDD	VB
NRCXH	VB
XWCPH	NN
QMP	NNP
LHTPJR	VB
QMW	VB
BAFR	IN
EWDP	NNT
HWLDTW	NN
KWWIIT	NNP
MFEMM	JJ
AIMPRSIWNISJIWT	JJ
ALJRNJIWWH	NN
WLSJN	NNP
HIFNWT	NNT
MWGBR	JJ
RFIMT	NNT
GML	NN
MJWWXI	NNT
XQRW	VB
MLXIM	NN
NJXNIM	JJ
MBCET	VB
MDBIQH	VB
NIGWD	NN
GMR	NN
ADM	NN
MWGBL	JJ
MWNWPWL	NN
RFIMH	NN
PWLIJIQH	NN
CIRP	VB
GDWL	JJ
BRZ	NN
FLBIW	NN
TIKP	RB
QFRI	NNT
QFRH	VB
GDWD	NNT
EWNFM	NN
GDWF	JJT
ALWNIM	NN
IHLWMIT	NNP
AWMDNIM	NN
HWMNIZM	NN
BRI	JJ
MCWIRWT	JJ
MEBR	IN
CIRI	NNT
FJXH	NN
FJXI	NNT
RWWXIT	JJ
KABI	NNT
PTIXWT	NN
MTMQD	VB
QLIJH	NN
HTGFMWT	NNT
FIJH	NN
IWLIKW	VB
FIINPLD	NNP
HRXIQ	VB
LNTX	VB
ARKH	VB
FMX	RB
LHPEIL	VB
NTPRIM	VB
TBWSH	NN
PWRSMH	VB
CWRKIM	VB
AMICH	JJ
PWRMLIT	JJ
PWLNIIH	JJ
LHPRID	VB
KLA	NNT
ETIQH	JJ
AINNW	RB
KLL	NN
RAWIWT	VB
HWDH	VB
KLH	NN
KLI	NNT
DXIIH	NN
XIDWFW	NN
MQWDF	JJ
DXIIT	NNT
QIIZRSLAWJRN	NNP
LHWPIE	VB
LTKNN	VB
ETIQT	JJT
PFJWT	NN
FBWEWN	NN
FMWNIM	CD
RZUL	NNP
IDIEWT	NN
HWDPSW	VB
MDMIE	JJ
NSIEWT	NN
HIINW	AUX
HMCIA	VB
AIWNIR	NNP
ALWPH	NN
DRKIHM	NN
MFBIE	JJT
LHEIZ	VB
NHNW	VB
IWPELW	VB
LIMWDIM	NN
MNT	IN
QNIWN	NN
IIWWTRW	VB
LQDM	VB
MKIRH	NN
RKIFTH	NN
QNIWT	NN
BGD	VB
LHWRID	VB
MNW	NNP
MFAIT	NN
BWAH	NN
RAPIDIH	NNP
LHEID	VB
QBWCH	NN
BWAI	VB
HTERERWT	NNT
MTLWNN	VB
QDRWT	NN
FMC	NN
MWPTI	JJ
IQRAW	VB
MMWL	RB
NPRD	JJ
IRWDWT	JJ
FMA	QW
QBWCT	NNT
MEIDIM	VB
TMWH	JJ
QWLQJIWWIT	JJ
PRLMNJ	NN
MPWRJ	JJ
RWMMH	NNP
HCHRH	NN
MZLZL	VB
BLGRD	NNP
ZIHWI	NN
BIRQNAW	NNP
MWQDMWT	JJ
MPWRF	JJ
HTGBF	VB
AINSJINQJIM	NN
HKINH	VB
IWSH	NNP
HCHRT	NNT
TMWT	VB
MDBQT	NNT
QCRWT	JJ
MAWKZB	VB
HGNT	NNT
AKLS	VB
AKLW	VB
MJWRPT	JJ
BEBWR	IN
FWWIICRIIM	JJ
KLB	NN
1969	CD
FQRH	NNP
CIPWRH	NNP
BNM	NN
MZKRWT	NN
IWRFIHM	NN
MWRFE	NN
XCH	VB
LWXM	NN
FTWLIM	VB
MWRFI	NNT
IJENW	VB
MWRFT	NNT
XTNI	NNT
KWZB	JJ
MSWKNIM	JJ
LXCN	NN
RPWBLIQAI	JJ
ELIZIM	JJ
MKWWNIM	VB
ISWPQW	VB
ETIQWT	NN
MWRDIM	NN
ZKAI	VB
HXRIP	VB
JWPL	VB
LHFIB	VB
HTQFRWT	NN
LHFIG	VB
DCMBR	NNP
526	CD
QBUH	NNP
MPRNSIM	VB
TAILNDIT	JJ
LRKB	VB
JWPZ	NNP
SIIM	VB
SEWDI	JJ
GRMH	VB
BWRRIM	NN
IWTR	RBR
ITMWDD	VB
XDRIM	NN
CHUL	NNP
LHIKNS	VB
CWPIM	NN
NXFBWT	VB
AWQJWBR	NNP
HNXIWT	NN
TFWBWT	NN
AILK	RB
IWTM	NNP
GRMW	VB
MWBILH	NN
SIIP	NN
ZKAIM	NN
HRFLIQWBIC	NNP
IHWFE	NNP
SMRI	NNP
601,016	CD
TWQPM	NN
RWMNJIWT	JJ
XMDH	NN
NAMNIM	NN
HWENFW	VB
TWQPW	NN
MRXB	NNT
QWLWT	NN
ZKAIT	VB
PAZIH	NNP
IWFQEW	VB
JEWT	NN
IHIW	VB
XFBWN	NN
LHKBID	VB
01,050	CD
SWGIW	NN
MQWBLT	JJ
XQIQH	NN
HTRKZNW	VB
MINSWJIM	NN
IHIH	AUX
HKIN	VB
XWFF	VB
XWQIIM	JJ
MDRIKIM	NN
XFB	VB
DRIFWT	NNT
XFD	NN
QNIINIM	NN
BZMNW	RB
MQMILN	NNP
QDS	NNP
LSXWP	VB
AISLM	NN
XFP	VB
QISRWT	NN
CACAI	NNT
XFW	VB
MCWPIM	VB
AWMRM	NN
MKILH	VB
EFWRIM	NN
GWPI	NNT
FHWA	MOD
PTXW	VB
PTXH	VB
PAHD	NNP
MCAW	VB
FQD	NN
HDLPWT	NN
JRWD	VB
FHWT	NN
NPSID	VB
MLWNWT	NN
HTXLH	NN
MNIET	NNT
SUM	NN
TFPRNH	VB
MFIG	VB
RDAR	NN
HTKNSWT	NN
NKWNIM	VB
DIQN	NNT
MFQPT	VB
ENIFH	NN
RCWET	NNT
NAFMIM	NN
AINNH	RB
ZMNNW	NN
QPIJLIZM	NN
FQR	NN
GM	MOD
SPRWT	NN
FWRRIM	VB
TRGWM	NN
SWCIALIIM	JJ
RCWEH	NN
BGDIM	NN
FKNIM	NN
GRSWT	NN
RBEWN	NN
WWSJ	NNP
MBHIR	VB
LWMDI	NNT
NWKXWT	NNT
MPELIM	NN
IBWAW	VB
MTWQNT	JJ
1	CD
NPGFWT	VB
RLWWNJIT	JJ
IBWAN	NN
MPELIT	JJ
AWKLWSIIT	NNT
JRBLINQH	NNP
LSKN	VB
RWWXI	JJ
MITAR	NN
LHRAWT	VB
PRQIM	NN
FXWR	JJ
FXWQ	JJ
EMLW	VB
PRQIS	NNP
4500	CD
NTWNH	VB
ILKW	VB
CIWNIIM	JJ
DIQJIM	NN
IQRA	VB
MTLMDT	NN
MXLQIM	VB
NAIM	JJ
XPCM	NN
MMWQDT	JJ
LHDHIR	VB
DBRIM	NN
HWLK	VB
CMXIH	NN
DBRIH	NN
HWQM	VB
DBRIW	NN
XWQR	NN
HFKILW	VB
LABJX	VB
QIBWCIM	NN
FIXTW	NN
HXLFWT	NNT
XLPWN	NNP
MEBRT	NNT
IICGH	VB
BIXS	IN
FILX	VB
HJBETW	NN
MXQR	NN
AWRCQI	NNP
MSTKMT	VB
BJWXWT	JJ
IICGW	VB
FILH	NNP
WWTIQH	JJ
FILM	VB
BIXD	RB
MFAB	NN
HQDMT	NNT
QPH	NN
ASWMN	NNP
JRIWWIALIWT	NN
MHFK	ZVL
KWKB	NN
MFAJ	NNP
QPC	VB
LHFXIT	VB
LHFXIR	VB
MFAL	NNT
ILIDIM	NN
TZKIR	VB
SRGLIM	NN
EREWR	NN
MHPKNI	JJ
MQWCRT	JJ
DWKN	NNT
MFTQPT	VB
HRT	JJT
SWBSIDIH	NN
HRP	NN
HRS	NN
HLIK	NNT
MDLIIT	NNT
HRI	RB
HRH	JJ
MIRWN	NNP
SPRD	NNP
MWPIEWT	VB
HRG	NNT
MIRWC	NNT
HRC	NNP
TPX	VB
AQDMAIIM	JJ
TXWMW	NN
MRWKZIM	VB
GRSAWT	NN
HWFMDW	VB
MZWHH	VB
RZRWWH	NN
HNNW	PRP
TXWMI	NNT
JQBSARN	NNP
PSIQWTIH	NN
HNPFH	NN
QCBIT	JJ
DNIAL	NNP
GRWSLM	NNP
XGABI	NNP
MXRIP	VB
EIILH	NNP
TKFIJIM	NN
3.23	CD
CIBWRIIM	JJ
LIDI	IN
BFBIL	IN
NKFL	VB
HWEMDW	VB
EZIQRI	NNP
LWMDWT	VB
GBEH	NN
RAIH	NN
KNWTH	NN
AMNWTIWT	JJ
MFKNEWT	JJ
MTBCEWT	VB
BMIWXD	MOD
MFNHW	NN
RFP	NNP
RFT	NN
ENH	VB
MWGMRT	JJ
TLIIH	NN
SJAZR	NN
HXJAH	NN
MAIDK	RB
BXRH	VB
ECRWT	NN
ZIWWGIM	NN
HARIKH	VB
RFM	VB
HXWCH	RB
PLILT	JJ
SWQRISJWB	NNP
FWFIQ	NNP
HLAH	RB
BWRA	NN
JQSIM	NN
IMIM	NN
DBQI	NNT
IMIN	NN
PWQD	VB
MLWQQ	JJ
BWRH	NNP
MWCNEIM	JJ
IMIW	NN
BWRR	NN
LJPLL	VB
PLILI	JJ
BWRX	VB
XKMI	NNT
XWDFIIM	NN
IWMIT	JJ
TKNWN	NN
AXRWT	JJ
XDFWT	JJ
AXRWN	JJ
FIQWMM	NN
FIQWMH	NN
KWWIIH	NN
HPSQH	NN
KNGD	IN
IIPGEW	VB
MIFXQ	NN
TAWRT	NNT
QTDRLH	NN
QIJL	NNP
QMH	VB
NKWNWTH	NN
KESW	NN
QIJF	NN
NKWNWTM	NN
SGWRH	JJ
SED	NN
NKWNWTW	NN
MGZR	NN
HFTLJW	VB
ITMID	VB
HFKL	NN
HTEWRR	VB
ISBWL	VB
CLH	NN
MARQIM	NN
PIRZWL	NN
IMI	NNT
RPIX	NNP
PISIWT	JJ
PWNQCIWNLIT	JJ
150,000	CD
AWSIP	VB
TWRWT	NN
QPLN	NNP
SWXR	NNT
SWXP	JJ
FWALT	VB
AINJLQJWALIT	JJ
LAPFR	VB
JABH	NNP
APWQLIPJI	JJ
AWR	NN
SJIWWN	NNP
KLLIM	NN
TWRGMW	VB
NSTIIM	VB
PWANJWT	NN
WWLSJN	NNP
GIHNWM	NN
MIIQL	NNP
FRIRNIM	NN
SDRH	NN
MTXZH	VB
MTQBL	VB
NGZRH	VB
NXFDH	VB
BEIJT	NNT
DIIRIM	NN
EWRQI	NNT
BEIJH	NN
TIIR	NN
NQMTK	NN
QWRWT	NN
PDRJIWWI	JJ
MSWIIM	JJ
IMIT	NNP
ESQIWT	JJ
NWBET	VB
PWLNIT	JJ
MZMINIM	VB
JWLSJWI	NNP
MTRKZIM	VB
EWFH	VB
CDDIM	NN
AWUM	NNP
IWNIM	NN
AWRALI	JJ
HIRLAP	NNP
DRWMH	NN
IWNIT	JJ
ALMWZLINW	NNP
ICIL	VB
PWLNIM	NN
ACJLH	NN
EWFR	NN
NWSIIRAT	NNP
LHWLID	VB
CMAIM	VB
MLA	JJ
AWHDI	NNT
NFQM	NN
ZMNW	NN
KMWIWT	NN
MLK	NN
MLH	NN
RWWXIWTW	NN
HCXIQ	VB
MLL	NN
LHWLIK	VB
MLR	NNP
BGNWT	IN
RAIITH	NN
ZMNI	JJ
AWHDT	JJ
MLX	NN
MBCEI	JJ
JRNR	NNP
PSQI	NNT
MWAPL	VB
CBEI	NNT
TTQBL	VB
MQIP	JJ
FRWIH	VB
MFWSE	JJ
DGMIM	NN
TWWIWT	NN
ZEZWE	NN
AWLIMPIWT	JJ
RIAD	NNP
RIFIWN	NNT
HWBJXH	VB
RIAL	NNP
NMKRW	VB
HRAH	VB
CBEW	NN
QISR	NNP
KNSIIT	NNT
APWJRWPSWT	NN
JHWRH	JJ
JWRQIH	NNP
SNDLRWT	NN
JWRQIM	NN
JWRQIT	JJ
XAG	NN
NBLMW	VB
ZWLIM	JJ
KNSIIH	NN
TLIWNIM	NN
AHRWN	NNP
ARIH	NNP
FMALNIM	NN
IFWBIM	NN
MDRFH	NN
ARIG	NNT
IEQWBI	NNP
SBIBH	NN
HPQWT	NN
MJRWTIW	NN
TELWLI	NNT
BEWD	IN
ADI	NNP
HERCT	NNT
FXQNIWT	NN
KNH	JJ
ZRWE	NN
H	H
MTECMT	VB
HRIGH	NN
LHRWWIX	VB
DIIHJSW	NNP
LHTPLL	VB
HLPRJ	NNP
BQFTW	NN
NWEZT	JJ
HRIGT	NNT
ZRWT	NN
LHTPLX	VB
EQB	IN
HRTEH	NN
KNS	NN
MHWTIIM	JJ
MMWFKT	JJ
TTQWP	VB
MFMEWT	NN
SGNIW	NN
PIGWR	NN
MWEDI	NNT
MDEWT	NN
RENNWTW	NN
MWBA	VB
LXC	NN
LGIJIMI	JJ
HIABQWT	NN
LXN	NN
AMPIRI	JJ
MWBN	NN
QIINI	NNP
DMGWGIWT	JJ
XJIBH	NN
QLIWWLND	NNP
BELI	NNT
BELH	NN
KIFRWN	NN
KRJIS	NNT
NIGF	VB
EBRIINIM	NN
BGDTI	VB
BRQ	NNP
3271	CD
QCHW	NN
XJIBT	NNT
DPNIM	NN
BELT	NNT
EIRIIT	NNT
HIEDRW	NN
HSKMTH	NN
IRMIHW	NNP
ZWPR	NNP
HSKMTM	NN
XIPFNW	VB
BRL	NNP
MFKILIM	VB
ANJWNIW	NNP
EIRIIH	NN
ECMAWT	NN
ELWMIM	JJ
LXSL	VB
RWZNBRG	NNP
TMUT	NN
LGBF	VB
TXWFWT	NN
TMUS	NN
LINQR	NNP
IRWQWT	JJ
LGBI	IN
HWCIA	VB
HWXMCH	VB
MXZR	NN
SJWDIW	NNP
QRWBIHM	NN
IIXS	VB
LEMEM	VB
MCJBRWT	JJ
BRD	NNP
RIIMWN	NNP
RWZLSR	NNP
GWPNI	JJ
GDWT	NNP
NZEQ	VB
23	CD
BIWRWQRJ	NN
LIQWI	NNT
NIGN	VB
MFMEWTIT	JJ
SIEWDI	JJ
MQWWH	VB
ARSNL	NNP
MWEILH	JJ
MXMIRH	JJ
SWRIH	NNP
HLKWT	NN
28	CD
MWRDI	NNT
HARD	NNP
yyDASH	yyDASH
IFNIM	JJ
AWWT	NNT
62	CD
HTQFRTI	VB
64	CD
65	CD
66	CD
NBXRTW	NN
68	JJ
RISSW	VB
SRGL	NN
JRMP	NN
MGPWN	NN
PRWCWT	NN
HSTBRWT	NNT
ZBL	NN
MIJRAN	NNP
BXIRTW	NN
XILWNI	JJ
ATPJR	VB
BXIRTM	NN
MNQRWT	JJT
QBENW	VB
509	CD
TXQWR	NNT
505	CD
AQLIM	NN
500	CD
FISWI	NNT
SIKT	NNT
632	CD
TCLWM	NN
MFIMTW	NN
QARN	NNP
NXWM	NNP
MMUN	NNP
GWRWDNH	NNP
BRIAN	NNP
FIPRW	VB
FNATM	NN
HWBEH	VB
TWKL	VB
IFIMW	VB
SIKM	VB
SNJRW	NN
FBWEI	JJ
MFRWT	NN
QARW	NNP
MGIJWLW	NNP
IHWDI	JJ
IHWDH	NNP
3.1	CD
XWPFH	NN
XWPFI	JJ
MLKTXILH	RB
FBIM	NN
CWRPW	VB
ERBIM	NN
EBWT	JJ
NWXH	JJ
QFRIM	NN
MSXRIT	JJ
HCHRWTIW	NN
EBWR	IN
SRJNIWT	JJ
BITIIM	JJ
QLINIWT	JJ
XWTMH	NN
LIBRJI	NNP
IFMIE	VB
QLCQIN	NNP
FBIL	NNT
HCHRWTIH	NN
QLLWT	NN
QWLXWZ	NN
XWQIWT	NNT
NXMN	NNP
NIBWLI	NNT
LIMPH	NN
EITWNAIM	NN
TIKWNIIM	JJ
MLMJH	RB
MLMILIAN	NNP
LIDS	NNP
EITWNAIT	JJ
HSTIIGWT	NN
RPWAIIM	JJ
BEIITIIM	JJ
CBEWNIIM	JJ
LSLAW	NNP
HCTH	NN
MWCUF	NN
LFWWA	RB
IS	NNP
LEBWR	VB
LEBWT	VB
SLWCQI	NNP
ALBRJW	NNP
IN	NN
NFAR	VB
PANI	NNP
TTXRH	VB
GRGWRI	NNT
LEBWD	VB
QWMPLQS	NN
IF	VB
LHMLIC	VB
NWTRW	VB
GIBSWN	NNP
QRIATW	NN
QWLQJIWWI	JJ
CLE	NN
RWXNI	JJ
LCH	NNP
SIPRTI	VB
MFENT	NN
RKIFWT	NN
AMIRH	NN
GALAJASRI	NNP
IASR	NNP
XBRTW	NN
AIRIT	JJ
ARIAL	NNP
TEWZH	NN
RCIXTW	NN
RKBW	NN
XLWQH	NN
RKBT	NN
XLWQT	NNT
TDIAWF	NNP
MWLWT	NN
SIWRI	NNT
SIKWNI	NNT
MWNJRIAWL	NNP
NCRT	NNP
TGWBWTIH	NN
BLPWR	NNP
SBLNWT	NN
FDIM	NN
AXHUC	NN
MIKRZ	NN
SXP	NN
SXR	NN
TKNITW	NN
PSIMIT	JJ
MCJIINIM	NN
HFERWT	NN
IERER	VB
TWRNWT	NN
AGRWT	NNT
XINWKIIM	JJ
MPXDT	VB
FARIT	NNT
MAGAR	NNP
WWRWDH	JJ
LHFLIM	VB
NGML	VB
FWABIM	VB
RWQMN	NNP
RWMNJIM	JJ
ESWQ	VB
SISLI	NNP
ZQWQH	VB
XWSL	VB
ARKW	VB
NSIEH	NN
XWSK	NN
EQRWNI	JJ
HIDRAWLIT	JJ
KTWMIM	JJ
JJRIWT	JJ
MTNHLT	VB
HWNX	VB
XZQH	JJ
HWNW	NN
MHWDQT	JJ
XWSR	NNT
QRWIP	NNP
HWSPNW	VB
HAFIM	VB
ZKIWN	NN
RWWXH	NN
MFXDIM	VB
MNHIGIH	NN
WWNSDII	NNP
MNHIGIM	NN
FRIPWT	NN
FINI	NN
FINH	VB
ARMWN	NN
MNHIGIW	NN
NBXRIM	NN
ZLCR	NNP
NIGWDIM	NN
NRGZIM	JJ
HTIIFBH	VB
XBRTN	NN
NSGIR	VB
LBKM	NN
TDMIT	NN
BRBRX	NNP
MERKWNIM	NN
MKSWT	NNT
SMKWTH	NN
RWMAN	NN
FBWEWT	NN
FRIRWTI	JJ
LWWTR	VB
XWRGT	JJ
PWINJ	NNP
LHSTDR	VB
MWSIQLI	JJ
BRBRH	NNP
MIIXDT	VB
LIWWH	VB
MNCX	NN
TWSPWT	NN
XBRTI	JJ
TNUKIT	JJ
IWELH	VB
NIGNH	VB
PNIMIWT	NN
TRM	VB
NKNSNW	VB
HGNTH	NN
HGNTI	JJ
MTN	NN
TRD	VB
QUQ	NN
AIAN	NNP
DWMH	JJ
FIFI	NNP
XBRIM	NN
MTBWNN	NN
CBAIIM	JJ
MEKBT	VB
IWELW	VB
NKFLH	VB
LIIQR	VB
EIZAT	NNP
HLKH	NN
FILFWM	RB
JRMPISJ	NN
HRIEW	VB
MCIINIM	VB
MLAKWT	NN
HLKT	NNT
HLKW	VB
LHISPG	VB
FIFH	CD
NKFLW	VB
MBLBLIM	VB
JMWNIM	VB
NPTLIM	JJ
FBWEIWT	JJ
RWQI	NN
IFXQW	VB
MWCAIM	VB
LWQAL	NN
XQIRT	NNT
ADIRH	JJ
KTWM	NN
MWEJH	JJ
MQRIM	NN
6691	CD
DIQLM	VB
HTQFRW	VB
KTWB	VB
HWPQW	VB
HNPQT	NNT
HDQ	NN
HWFIJW	VB
NMCAWT	VB
HWDET	NNT
MIICRIM	VB
XLWPWT	NN
QRWNIT	NN
HEZ	VB
DRWR	NN
AJRQJIWWIT	JJ
CILWMI	NNT
LHIENWT	VB
HCBTM	NN
EDFWT	NNT
HWGBLW	VB
APWDWT	NNT
NXFBT	VB
753	CD
752	CD
ELH	VB
FMFWT	NN
RDP	VB
MIMRH	NN
MQRIB	VB
XLFWT	JJ
FFT	CDT
IWFRW	NN
AWRKW	NN
DRGIM	NN
NWZPT	VB
QWRE	VB
NPGF	VB
ISKIM	VB
FMFWN	NNP
23.90	CD
RDI	NNP
ELW	VB
ELT	NN
TEFIWT	NNT
7.1	CD
FBTI	NNP
SPILBRG	NNP
FBW	VB
LEGM	NN
PLIJT	NNT
TEFIH	NN
TWMIJI	NNP
FBX	NN
MDIM	NN
MDWRGT	VB
PWFRT	JJ
HDRGH	NN
MAXWRI	IN
NXZWR	VB
FBE	CD
MGRFM	NN
FBJ	NNT
PLIJH	NN
FBH	VB
PWSJ	NNP
MGRFH	NN
FBTW	VB
20.30	CD
IIASRW	VB
AWPIINIIM	JJ
JEH	VB
MICMC	VB
ICRNIT	NNT
MXIR	NN
MNWXTI	NN
MXIH	NN
MMWNH	NN
PANL	NN
MKBIM	NN
BIEWR	NNT
MKBIH	NN
MSXRIIM	JJ
JKNWLWGIWT	NN
AHBH	NN
4.2	CD
HZDMN	VB
SGR	VB
ZRWEM	NN
CIBWRIT	JJ
TQPWTN	NN
MPTIEWT	VB
5	CD
SGL	NNP
JNQIM	NN
SGN	NNT
AHBT	NNT
AHBW	VB
LHWFIE	VB
MTKWWNWT	VB
HZMNH	NN
MIFH	NNP
IRIBWTIH	NN
MIWEDT	VB
BRQIN	NNP
XSIDIM	NN
ICA	VB
XZQWT	JJ
DWQJWR	NN
LFPWJ	VB
CNE	NN
QWMPQJ	NNT
ZRMIM	NN
TWRIM	NN
HQHIL	VB
GLWIH	JJ
NQLEH	VB
HZMNT	NNT
PWBLICISJIQH	NN
MPGEI	NNT
FLJT	JJ
BBRKW	NNP
BIRDSLI	NNP
FLJW	VB
PFE	NN
XFIPH	NN
DXW	VB
FWABT	VB
MWEMDW	NN
NICXWNH	NN
DTIWT	JJ
DXQ	VB
DXP	VB
25.90	CD
NICXWNW	NN
HMIJH	VB
DXH	VB
KWBEIM	NN
XFIPT	NNT
PEMI	JJ
MQWJET	JJ
BMH	NN
PQID	NN
ARWKIM	JJ
NRKFH	VB
MIIDI	NNT
TTIR	VB
MFIKT	NNT
BWSRIWTW	NN
MWJEH	JJ
GDWLTW	NN
AWJWBIWGRPI	JJ
GDWLTH	NN
IAHBW	VB
NFBRWT	VB
TRWPT	NNT
ANDRSWN	NNP
NGWHWT	NN
MTQDM	VB
AWPCIH	NN
ZCUL	JJ
WWADINGR	NNP
CIPWR	NNT
HXRPT	NNT
GLEDI	NNP
ANWFIWTM	NN
NJENT	VB
27.90	CD
TWFME	VB
TLMIDWT	NN
LHEIR	VB
CIPWI	NN
HDWRIM	JJ
MLXMT	NNT
APIDMIWLWGIIM	JJ
LHWQIR	VB
RWNI	NNP
MJH	NN
MARGNIM	NN
MPIIST	JJ
ITMKW	VB
MKIRT	NNT
GIA	NN
GIM	NNP
GIL	NNT
PWELIM	NN
MTNKRT	JJ
GII	NNP
RAFH	NN
SCINWT	NN
WINICIW	NNP
JIPX	VB
AZBIW	NNP
PRANQ	NN
MFWLLT	JJT
LHTMNWT	VB
JIPS	VB
AHH	NN
MENW	NN
NPC	NN
MFWMF	JJ
ITRH	RB
JIPH	NN
RICH	NN
NSWG	VB
NPT	NNT
MENG	VB
ASNT	NNP
AGWUI	NNP
TFBC	NNT
IWZMWT	NN
MPZRI	NNT
QWDMWT	JJ
CDI	NNT
LWQRI	NNP
IRIBTH	NN
AIRPN	NNP
HTNKLWT	NNT
TBIEWTIH	NN
IXTMW	VB
MFAIR	VB
LWEGIM	VB
MTGEGEIM	VB
SAQRMNJW	NNP
MLIWN	CD
BNIINIM	NN
TBWSTW	NN
FMIR	NNP
PISIT	JJ
NWPIT	JJ
MSKI	NNT
CDW	NN
0203	CD
GZRTH	NN
AIJWM	NNT
ICWRP	VB
ABLWT	NN
HSQT	NNT
MTXIIB	NN
KWTRTH	NN
HTAWFFWT	NNT
FITQW	VB
QRIRH	JJ
CWEQIM	VB
MHWWIM	AUX
HAFMWTIW	NN
TPIFWT	NN
TXINTW	NN
KPH	VB
LZRWQ	VB
MILIWNI	CDT
LZRWS	NNP
KPL	NNT
RAFW	NN
MPSIQIM	VB
HBIEW	VB
LHCIE	VB
MQCTH	NN
HWKXWT	NN
FLIJTNW	NN
IRWFLMIIM	JJ
MWDH	VB
MDINAIM	NN
HWSPH	NN
HKPLT	NNT
FRIJWT	NN
MWDN	NNP
MWDD	VB
HBIEH	VB
RCWI	VB
LQBWE	VB
IALC	VB
DISNI	NNP
CNWEH	JJ
MEWBDWT	JJ
LFNWA	VB
ALMNTW	NN
NWLDW	VB
ABINR	NNP
TEWDWT	NNT
LPQWD	VB
NWLDH	VB
MFLWX	NN
TLMIDI	NNT
EWRKIM	VB
XWQTI	JJ
MMLAIM	VB
LFNWT	VB
GBEWLI	NNT
DWMIW	NN
RKWFW	NN
BWDHISJIT	JJ
LHLWM	VB
PRANQIM	NN
SPRWTIWT	JJ
SIMNI	NNT
JRIJWRIALIIM	JJ
HTRAIIN	VB
RDWAN	NNP
HTXZQ	VB
MRPAH	NN
EL	IN
ER	VB
NCIGWT	NNT
SPIR	NNP
IPNH	VB
MFPIEWT	VB
NXLIT	VB
IWFBWT	VB
AINJRS	NN
QBRI	NNT
GWNS	NNP
QBRW	NN
GWNN	NNP
AMIN	NNP
HSTIIMW	VB
GWNI	NNT
HPTIEW	VB
XIRWM	NN
MWDRNIT	JJ
XWRXH	NNP
NICXW	VB
MTERBIM	VB
HTRAH	NN
QUG	NN
AMNIM	NN
AXIDH	JJ
AMNWIWT	NN
SWCIAL	NN
HIID	NNP
PRSH	NN
QIBWCIWT	JJ
60838430	CD
PGM	NN
NICXH	VB
MEWGLIM	JJ
MGH	NNP
BELWTW	NN
RFMT	VB
SQNDINWWIT	JJ
MSIJIM	VB
XRDWT	NN
XSRWT	JJT
XWJI	NNT
BNIIT	NNT
MGN	NN
6891	CD
SQNDINWWIM	JJ
LHTXKM	VB
QLIBWRN	NNP
THPWK	AUX
RFMI	JJ
MRIDWR	NNP
MRIDWT	NN
TICWR	VB
HAPJ	NNP
MWZKRIM	VB
GARDN	NNP
5.4	CD
5.5	CD
MDUA	NNP
MWJEIT	VB
DIWQNAWT	NNT
MZIZH	VB
BXINTH	NN
MCIPH	VB
HKINW	VB
MPTXIM	VB
HRISWTIHM	NN
KMWBN	RB
ATNIWT	JJ
XINWKI	JJ
AITNH	JJ
SIMS	NNP
GRMNIIM	JJ
LFKH	NN
MMSD	NN
AWSRT	VB
BQBWQI	NNT
INWKW	VB
ILDIW	NN
DWPI	NN
HQNIWT	NN
LZKWT	VB
TTKNS	VB
CACA	NN
ILDIM	NN
TRWMWT	NN
MSPIQ	VB
IIMFKW	VB
GRIM	VB
GRIN	NN
MGNWM	NNP
XFBWNW	NN
FTILIM	NN
IDIDIM	NN
LHPQIE	VB
HCLXWTIW	NN
TWMK	VB
EMIDR	NNP
IDIDIH	NN
NPLH	VB
IDIDIW	NN
TWMS	NNP
CRLSJWN	NNP
ALXNDRW	NNP
MAPFR	VB
MAMINH	VB
AMIR	NNP
MGALWMANIT	JJ
AXIM	NN
AXIH	NN
FITWQH	NN
XWLWNIM	NN
HDWQIM	JJ
ALMWLZINW	NNP
SWBLWT	VB
NWFA	NN
LINH	NNP
NWFM	JJ
NWFL	VB
LINC	NN
HXMIR	VB
NWBEIM	VB
MCJIIN	VB
MGZINIM	NN
HWDXH	VB
XZR	VB
GWJPRID	NNP
PJRIWJ	NN
GZENI	JJ
AILWCI	NNT
THPWKWT	NN
MIIBAT	VB
HWGI	NNT
HRGFT	NNT
MCWINIM	JJ
MCJIIR	VB
XZH	VB
FWTPWIWT	NN
IIEWDIIM	JJ
AGDT	NNT
PALS	NNP
L	IN
DIRWTIW	NN
MIDRDR	VB
EINWIIM	NN
AGDH	NN
PNJZIWT	NN
TTXTN	VB
DISQIM	NN
PALC	NNP
BSISIIM	JJ
RIMWN	NNT
HQLJH	NN
XQIIN	NN
MPAUI	NNP
HWGF	VB
JAJSWAW	NNP
HTGWRR	VB
JQS	NN
SNIGWRIWT	NN
MWERKT	VB
HSEIRH	VB
TACR	NNP
AMITI	JJ
HQLJT	NNT
ASWRIM	VB
LXFWF	VB
HWDXW	VB
LXFWD	VB
IWGWSLWWI	NN
LXFWB	VB
JIST	NNT
NWBMBR	NNP
XIFWBIM	NN
AIXRH	VB
DWRIT	NNP
MTXWLLIM	VB
RAMASWWAMI	NNP
BLWWIW	NNP
ENIBH	NN
NAFMI	NNT
MSTDRWT	VB
LBWNJIN	NNP
MKWNWT	NN
TQWE	VB
AMITIT	JJ
XNKH	VB
WWADI	NN
IWECIM	NN
MPEIL	NNT
ZQNI	NNT
IWZRMW	VB
TNWPH	NN
TRWMT	NNT
MLXMTH	NN
HGNH	NN
LSWR	VB
MRGRJ	NNP
ESQI	JJ
ESQH	VB
ZMNIT	JJ
MSGRWT	NN
BECLTIIM	RB
XLWNWT	NNT
MTW	VB
yySCLN	yySCLN
HTXIIBH	VB
AWLMWT	NNT
HWCAH	NN
MWJWT	NNT
PRWSJ	NNP
LQ.P.R.	NNP
ESQT	NNT
RDWD	JJ
IQNW	VB
MTABL	VB
MSGDIM	NN
XWMR	NN
MFPJIM	NN
HDXH	NN
FIPWCNIQ	NN
HPNIIT	NNT
RZIN	NNP
AILWCIM	NN
NEFWT	VB
XCIH	NN
FPIGL	NNP
TRWMH	NN
MTNDBIM	NN
IQNH	VB
AIMW	NN
AINJIMIT	JJ
ELIZH	NNP
TMIMH	JJ
XDIF	JJ
MRNFJIIN	NNP
TIFAR	VB
SPIXT	NNT
JJRINPWRM	NNP
MERKWN	NN
XDIM	JJ
XDIR	JJ
KINWN	NNT
EISQIIM	JJ
MWLIKIM	VB
MWBILWT	JJ
BITN	NN
QSMIM	NN
FEWRM	NN
BITI	JJ
BITH	NN
LHBDIL	VB
CBINSQH	NNP
BLWBFJIIN	NNP
MTPRC	JJ
XILWQI	NNT
ETIDIIM	JJ
HQDIM	VB
LAWWN	NNP
BITW	NN
MXZWRI	NNT
LBIN	IN
TIPTR	VB
MMISIM	NN
GIREWN	NN
AIMH	NN
MXZIQ	VB
EWPRI	NNP
ICXQ	NNP
XLASQ	NNP
BIQFTI	VB
AIZW	WDT
13.90	CD
KRGE	RB
MPTX	NN
QNDL	NNP
HSLMH	NN
XWLMWT	VB
MWBNT	VB
AWMFLAGPLAC	NN
MPTN	NNT
BELIM	NN
BELIL	MOD
XTIRTH	NN
PASIWN	NN
GWMWLQH	NNP
LBKWT	VB
LIWWIT	VB
MRI	NN
TAMC	VB
SJTH	VB
GINQWLWG	NNP
QRAQSI	NNP
TEMWD	VB
FIDWR	NNT
ZAPJWT	NN
TEBWR	VB
FIDWK	NN
PWPWLRIWT	NN
TAMR	VB
FIDWD	NNT
NLXMIM	VB
XIRWT	NN
LHDQ	VB
ZINQ	VB
JAZIMH	NNP
MQIIMT	VB
XWWIH	NN
HCXQWT	NN
QWNJRS	NNP
XWWIM	VB
QPDNWT	NN
JSIM	VB
TQBLW	VB
TSLX	VB
FLJWNWT	NN
AFUL	NNP
MAHL	NN
63	CD
XM	JJ
ARRJ	NNP
MKINIM	VB
MKFLH	NN
MFNTM	NN
ARC	NN
BIJWXI	NNT
BLFIM	NN
HFIBH	VB
775	CD
MFQPIIM	NN
RFWTM	NN
IIFWT	NN
LWQRSIH	NNP
IHIIH	VB
772	CD
RBW	NN
LNKWT	VB
MTBCET	VB
LIMWDIHM	NN
HWPQ	VB
WIIL	NNP
77	CD
IRIDWT	NN
75	CD
74	CD
73	CD
QFR	NN
71	CD
70	CD
AWRIT	NNP
RBE	NNT
EJW	NN
IEWDKNW	VB
IIFWM	NNT
79	CD
78	CD
QMBL	NNP
IMMH	NN
LBQPSPBIN	NNP
HFTNH	VB
NHIH	AUX
RFWTW	NN
HWPKIM	VB
WWJPWRD	NNP
LHQCWT	VB
TIHNH	VB
ATIAISJIM	NN
MWTAM	JJ
HMAN	NNP
XRIGWT	JJ
ZEIRH	JJ
LHFIA	VB
MIQA	NNP
PWNDMNJLIZM	NN
HWKRZW	VB
MNWCXIM	JJ
MFTRK	VB
MAPIIN	VB
NTLW	VB
RX	NNT
FWMRWN	NNP
HWERKW	VB
JL	NNP
XFWPWT	VB
NPF	NN
JI	NNP
HBWQR	RB
SJJWS	NN
67	JJ
PRIFT	NNT
MAFRIM	VB
AHDH	NN
NCIT	JJ
BRIJIM	NN
LFKTW	NN
GIBWRIM	NN
MXKH	VB
SILBIH	NNP
KIFWRI	NN
HKRIZH	VB
PIILI	NNP
ACUL	NNP
HSTPQ	VB
ASJRJGIH	NN
CRWRWT	NN
521	CD
HEIR	VB
QWNH	VB
ZWHRIM	JJ
FXWXH	JJ
IAH	JJ
GRMNI	JJ
SWGRWT	VB
BLGIH	NNP
BLGIM	NN
HGFNW	VB
ABXNH	NN
GLGWLIH	NN
MTKNN	VB
NBEJ	VB
HWSIPH	VB
LHRBWT	VB
MQWMW	NN
IPTWR	VB
AWJWMJ	NN
ASJRAJGI	JJ
LHPTIE	VB
ECBNWT	NN
TCPIWT	NN
CECWE	NN
KIKWBH	NN
MTWAR	VB
NISTH	VB
BQRWB	RB
THIH	AUX
AWMRIM	VB
LHSBIR	VB
CWQR	NNP
CXWQ	NN
FLHI	NNT
CEQNIT	JJ
MJILWT	VB
HDXTW	NN
AWKLWSIIH	NN
PRWP	NN
BS	NNP
IKRIE	VB
HKBDT	NNT
JIRN	NNP
RIWZABWRW	NNP
PRWF	NNP
BQBWQ	NNT
PRWC	NNT
JIRT	NNT
TQCWB	NNT
MTQFH	VB
AWPNWE	NN
LHFTBC	VB
2.1	CD
HESIQ	VB
2.7	CD
2.6	CD
2.5	CD
EWZR	NNT
GLRIWT	NN
NTIB	NNT
PRJNIWT	JJ
BEINI	IN
BEINH	RB
KWZBWT	JJ
CBAIT	JJ
NKNST	VB
NKNSW	VB
IENW	VB
CLWLH	JJ
NKNSH	VB
TXZIT	NN
EWZI	NNP
WBRAFT	NNP
SIIE	VB
HJIL	VB
MHN	QW
KRWNI	JJ
MHM	QW
NISIWNWTIH	NN
NTXIM	NN
NJWIH	JJ
BIDI	IN
MKDI	IN
BLINQWB	NNP
FKIRWT	NN
EIRAQ	NNP
FIIKT	JJ
MHW	QW
FWJIM	JJ
NISIWNWTIW	NN
MHR	RB
XNWIWT	NNT
AND	NNP
MFLMIM	VB
SIRWT	NNT
XFMWNAIM	NNP
SIRWS	NNT
KES	VB
ANI	PRP
PSIKIAJRI	JJ
MELH	NNT
JWENWT	VB
EQIBA	NNP
FBET	CDT
ANS	VB
DIMWNH	NNP
IPANIM	NN
9:00	CD
GZR	NNT
PNIH	NN
MWFG	NN
MFKIT	NN
MWFB	NN
MDINWT	NN
PMGWSJH	NNP
MCXIQNIM	NN
DIJRIK	NNP
MWFK	VB
WAN	NNP
HFLIJW	VB
CEIR	JJ
XWLFH	NN
MCWDDT	JJ
IZKH	VB
20.00	CD
PRFIIH	NN
NEMWD	VB
AWRJGH	NNP
AITNIM	JJ
FWJRI	NNT
MKWNH	VB
BLWNIM	NN
QWRAN	NNP
FLWXWT	NN
SKWM	NN
MFMRT	NN
KIBDH	VB
MKWNT	NNT
ATNXTA	NN
MSGIRIM	VB
HTERBWT	NN
TSQIRI	NNT
IWFMH	VB
XNIKIW	NN
HWDETI	VB
PNIITNW	NN
SGWRIM	JJ
TLUG	NN
KHWNTW	NN
KHWNTH	NN
KRK	VB
EWNFIM	NN
EWNFIN	NN
LHPIQ	VB
HWDETW	NN
QDWMH	JJ
ERBWIWT	NN
EMDWT	NN
RWXWT	NN
ZMNIM	NN
ICIATW	NN
EDIPT	NN
IRWFLMIT	JJ
RFWMWT	VB
CIPIIH	NN
IRWFLMIM	JJ
HGWN	JJ
IAJH	NNP
HSTXRR	VB
NZIL	JJ
5111	CD
19.1	CD
FNINWT	NN
EDNH	NNP
TZMN	VB
FGRT	NNT
19.9	CD
NKSIW	NN
TGBR	NN
LEWMQ	RB
FPLH	NN
MERBWNIM	NN
QNIIH	NN
86.90	CD
SHUK	NN
TKWNWTIW	NN
PJRWLGZ	NNP
IFXQ	VB
NHRGH	VB
BIRWR	NN
DMWQRJIM	NN
CBEWNI	JJ
MASJRS	NNP
NERMW	VB
FIBXW	VB
JKNWLWGIIT	NNT
PMLIITW	NN
IIELM	VB
9	CD
LNQWT	VB
ZWWEWT	NN
DIRTM	NN
PSIKWLWGISJI	JJ
EICWBH	NN
IIDW	VB
AWHDIM	NN
EWBRIM	VB
GWLP	NN
NWCRH	VB
MTEQF	VB
AWHDIH	NN
KIS	NN
MTENIINIM	VB
GWLI	NNP
GWLN	NNP
HPQH	NN
XIWNI	JJ
LGFR	VB
BRAFIT	RB
LGFT	VB
GWLD	NNP
72	CD
PEWLWTIH	NN
CMWDWT	VB
DINAMW	NNP
TAPWP	VB
IHMRW	VB
MTPRS	VB
NPSLH	VB
XWGGIM	JJ
TEBIR	VB
FIWR	NNT
SWPRT	NN
SWGRT	NNT
NXFPH	VB
MCIEH	VB
RPIDH	NN
SWGRI	NNT
LHTXMM	VB
DARN	NNP
SWPRI	NNT
AWSP	NNT
JLQWMWNIQCIH	NN
AWSR	VB
MEFIRIM	VB
LHBH	NN
JWJW	NN
NFWAH	JJ
JBEWN	NNP
ZKAIWT	VB
HKNH	NN
QWFRIM	VB
NXFPW	VB
LBRK	VB
LEZWB	VB
HKNT	NNT
LBRR	VB
JBEWT	NN
PIRSMW	VB
DIIWWID	NNP
DWRI	NNP
WIIDNPLD	NNP
KWNH	VB
PILDLPIH	NNP
DWRF	VB
TXNTW	NN
MKBD	VB
KWNS	VB
TTGFM	VB
MFTWLLIM	VB
TKZIB	VB
IDPIS	VB
MKBI	NNP
SWNWWRW	VB
NIFWAIN	NN
NIFWAIM	NN
HEBRTW	NN
PLILIIM	JJ
HGBIR	VB
HTBJAWT	NN
LIWWTH	VB
BTMWRH	IN
QWNJIQJ	NNP
HGBIH	VB
HEBRTM	NN
ARIZWT	NN
KRWKIM	VB
HWBAW	VB
IWRQ	NNP
AMWRIM	VB
NIFWAIW	NN
NFMTW	NN
LPXWT	MOD
GWRSIM	VB
BEIJWT	NNT
BWERT	VB
MDGRWT	NN
3.7	CD
MWKSP	JJ
SPCIPI	JJ
BRNE	NNP
NWDE	VB
NWDD	VB
ITBJLW	VB
MEWJR	JJ
TIKNN	VB
KHNA	NNP
37.40	CD
SBIBWT	NNT
NWEDW	VB
AHBIM	NN
LIBW	NN
CMAI	JJT
BRIWNWT	NN
LILH	NN
FMFWNIM	NN
RCIPWT	NN
LHTENIIN	VB
GLWNIM	NN
BIWGRPIIM	JJ
NWEDH	VB
BFETW	RB
AKSNIH	NN
GILWPIN	NN
LHSTIIG	VB
HIDRWTRPIIM	JJ
941	CD
WDAI	RB
CMXIIH	NN
NFMR	VB
CMXIIT	NNT
HTIIXSW	VB
MSWGLIM	VB
MWCIA	VB
MSRW	VB
HMLCWT	NNT
NFME	VB
NXRJ	VB
MTLHB	VB
WIIJNAM	NNP
HWJLH	VB
MTLHJ	VB
MQBILH	JJ
XWPFIT	JJ
HTNCLWTW	NN
LFXWQ	VB
MQBILW	NN
NLQX	VB
RKILWT	NN
HWJLW	VB
7891	CD
FQIDH	NN
HWJRDW	VB
XWBFIM	VB
SPRIW	NN
TWKNWT	NN
NIWWJ	VB
EGILIM	NN
5,779	CD
GZENIT	JJ
MWXZQIM	JJ
IIPTXW	VB
LTWK	IN
SPRIM	NN
LLEWG	VB
JBET	NN
SALM	NNP
XILWL	NNT
91.8	CD
ZITIM	NN
MPELWT	NNT
SMWKIM	JJ
AINDIANIT	JJ
CRIKWT	VB
MSWP	NNT
AKLWSH	NN
QREIM	NN
MGIFH	VB
XILWP	NNT
GILAIM	NN
LAWR	IN
SDIRH	JJ
ILDIHM	NN
LSQR	VB
XWPI	NNT
PFWJ	RB
XIBR	VB
HWPSQH	VB
ABDIH	NNP
HFBWE	RB
HIWTI	NN
HJIG	NNP
RWJNBRG	NNP
FXQN	NN
TQCIBI	NNT
NGID	NNT
NGIE	VB
BEIT	NNT
JRI	NNP
XLWQTH	NN
HTPTXWTH	NN
TQCIBW	NN
REIL	JJ
111	CD
JKNAI	NNT
HWJL	VB
NISWIIT	JJ
JRX	VB
SIIMW	VB
IIXWS	NN
TMIKH	NN
PIWRNJINH	NNP
WEIDT	NNT
HSBIRW	VB
IICAW	VB
QWMIT	JJ
EQBWT	NN
AISLAMIIM	JJ
IIAWF	NN
MXLT	NNT
MTIIMRWT	VB
IIXWD	NN
HSBIRH	VB
NPRFW	VB
TMIKT	NNT
SIIMH	VB
MIEJ	VB
TXRWIWT	NNT
MXLQ	NNT
JHWR	JJ
XWGIM	NN
AHWBH	NN
NBNTH	VB
XWLFTW	NN
ELIWNWT	NN
MFKN	NN
SPQIT	NNT
MXFBWT	NN
MFKB	NN
NWQBT	JJ
IHPKW	VB
TWQPNWT	NN
HIFRDWTM	NN
BRNAR	NNP
AIJIT	JJ
MZRXIT	JJ
JRWR	NN
HSPIQH	VB
BICIM	NN
QWSIGH	NNP
MSEDH	NN
MEWGNWT	VB
HNPT	NNT
PTXI	NNT
HTMSRWT	NN
TPWQT	NNT
MQWMIWT	JJ
RWMZ	VB
MRKZWT	VB
HWDEH	NN
NKS	NN
NFRQH	VB
TPWQH	NN
MFGRI	NNT
RIXP	VB
MSEDT	NNT
QHILIIH	NN
MSIIEIM	VB
PTXM	NN
IHRGW	VB
PRJIIM	JJ
EIQWL	NN
FWWI	NNT
HDRKH	NN
RFMIW	NN
RFMIT	JJ
FWWA	NN
MWKNH	VB
011	CD
012	CD
013	CD
HGDRWT	NNT
TWDETM	NN
HTECMW	VB
ADWARD	NNP
FWWT	JJ
ANRCIH	NN
HDRKT	NNT
IFTQP	VB
DRKW	NN
LHTXFB	VB
QJNH	JJ
ARWKT	JJT
AXT	CD
MWCR	NN
HPSIQW	VB
PWRMING	NNP
MQBWL	NNP
HGRLH	NN
AWZNIIM	NN
MTWKNNIM	JJ
112,000	CD
MXWWH	NN
ARWKH	JJ
DRKN	NN
DRKM	NN
MCIAWTIIM	JJ
DRKK	NN
IDIDWTIT	JJ
JILIM	NN
BMRWKZ	RB
ZWRM	VB
HXZIRW	VB
MCDIQ	VB
716	CD
EMWDW	NN
DMWIT	JJT
LHTAIM	VB
CPWIIM	VB
NICXIT	JJ
EWBI	NNT
XZWNW	NN
TQPW	VB
HGIEW	VB
ZKRNW	VB
LAZWR	VB
MHPKNIT	JJ
SBW	NN
CPIIH	NN
LAN	QW
KIFLWNW	NN
LAH	NNP
MHRH	RB
NTMK	VB
PEILH	JJ
AILNH	NNP
XWFNIT	JJ
FBXI	NNT
FFI	NNP
PINLND	NNP
NWHGWT	VB
LBNWNI	JJ
LAW	MOD
MBIIMIM	VB
LEKB	VB
MECWRIM	NN
NRATH	VB
LFKB	VB
DTI	JJ
LHZRIM	VB
PEIL	JJ
MIRBIT	JJ
XCWCRWT	NN
NSWTH	NN
MJRIDIM	VB
SJWDNJIM	NN
PWRXT	JJ
LFKT	NNT
ELWIWT	NNT
JWRINW	NNP
LBBIT	JJ
FILMW	VB
SWRQ	NNP
SWRR	JJ
NPIQ	VB
SBB	NNT
PLIQS	NNP
QBWCTI	JJ
RJJ	NN
QIDR	NNP
NIFAH	VB
IIMFK	VB
MWCDQWT	JJ
NQIIH	JJ
BDQNW	VB
MNIEH	NN
LIJAIM	NN
HEBIRW	VB
1630	CD
JWRNIRIM	NN
HJILW	VB
BELIH	NN
1989	CD
KGWN	IN
JXWB	JJ
TWRMT	VB
HTELMH	VB
MCIIN	VB
HTELMW	VB
IGE	JJ
CBWE	JJ
MEFIWT	JJ
SBK	NN
BEQIPIN	RB
HJILH	VB
PJM	NN
KNISH	NN
LWGISJIT	JJ
HTMXH	VB
AWNIBRSIJAWT	NN
HTAKZB	VB
CBE	NN
MRPA	NN
CBI	NNP
BIRWRIM	NN
LMELH	RBR
CBR	VB
MARXIW	NN
HTAKZR	VB
CWWT	NN
MWNIJIN	NN
MAXZIHN	NN
ARGWN	NN
NHRSW	VB
AMADWRH	NNP
FPIGLR	NNP
FWPN	NNP
PWGFIM	VB
BZQ	NNP
MEJH	JJ
JIPWLIT	JJ
SLJIQS	NNP
MPGRT	VB
IICWRW	NN
MJMWN	NN
AML	NNP
LWBLIN	NNP
MXWFLWT	JJ
ESQWT	NN
LHIHPK	VB
FJPW	VB
EWTRIM	NN
RFTW	NN
MFBXIM	VB
EKBR	NN
MPQDIM	NN
CMCMW	VB
MKIRIM	VB
HIKTH	VB
FPNIM	NN
BIRNDRH	NNP
RWMNIH	NNP
MINIH	RB
IBIA	VB
RWMNIM	NN
PARAQAN	NNP
MINIM	NN
ABIDWT	NN
SBIBTIWT	JJ
AWHBT	VB
IBIN	VB
EIKB	VB
MWFLKWT	JJ
NEZR	VB
NQIFTIWT	NN
RPIWN	NN
BRIXH	NN
LIPCIN	NNP
HWZKR	VB
MINIT	JJ
ALN	NNP
ERD	NNP
MBINWT	JJ
MWFLI	NNT
LWXMI	NNT
LWXMH	NN
AXIZTH	NN
HELATM	NN
MPQDIW	NN
TXKWM	NN
ALA	CC
IHLWMIM	NN
XANWN	NNP
BNQIM	NN
QWLM	NN
LHTMID	VB
ALW	JJ
TFTWWH	VB
LWXMT	NN
MWNJH	NNP
MXWIBIM	VB
MDRXWB	NNT
LHFKIL	VB
HBIS	VB
DIWMA	NNP
MWULWT	NN
MTWRGMN	NN
ICIAH	NN
MFMFIM	VB
IRAH	VB
FWWIICRI	JJ
HBIA	VB
HARWWARD	NNP
MWFMCIM	VB
IZIN	VB
HPTEH	NN
22051	CD
FRPWT	NN
NIKWR	NN
HBIJ	VB
NAFM	NN
MWHR	NN
HBIN	VB
PJRIWJIM	NN
HWCAT	NNT
SKWMIM	NN
HELW	VB
AZIQIM	NN
EITWNAIIM	JJ
LHTNKR	VB
LLQIN	NNP
LHIDRF	VB
EIQRWN	NN
NAMNH	JJ
AQWNWMISJ	NNP
QWLP	NNP
ETIRT	JJT
QWLQ	NNP
QRINT	NNT
BANW	VB
JIPLW	VB
PSIQTW	NN
TLWT	NN
FIWWIWN	NN
FIXRR	VB
HRIMW	VB
ANXNW	PRP
KTR	NNP
MWCGIM	VB
MNQRT	VB
LHTPRF	VB
TLWI	JJ
PWRMLIIM	JJ
AWGNIWQ	NNP
QRINH	NN
KTB	NNT
NASRH	VB
BHIRIM	JJ
NWSIIR	NNP
TESWQ	VB
IAWFRW	VB
HBIAW	VB
HIIFR	RB
LJINIT	JJ
HBIAH	VB
MSWBKT	JJ
LHFKIX	VB
MKFIR	NNT
XPIRWTIW	NN
HGFT	NNT
MTBIIF	VB
GLWT	NN
MSTEPT	VB
MSKMT	VB
SGRIRI	JJ
MZIMTW	NN
BZKWT	IN
MMCAIHM	NN
131	CD
LHGIF	VB
LHDGIF	VB
TGDL	VB
LHTGWRR	VB
RXWQIM	JJ
NZKH	VB
HWLNDIIM	JJ
GWRM	NN
IFPIEW	VB
TPGE	VB
IRWXM	NNP
NBWN	JJ
HTAIMW	VB
HRISWT	NN
FIRIM	NN
MJWRP	NN
AMRIQN	NNP
FRIQWT	NNT
HNHGTI	JJ
CKWSLWBQIH	NNP
MARXW	NN
MBQFIM	VB
QICWNIT	JJ
MRGIF	VB
5591	CD
ICRH	VB
MRGIE	VB
ICRN	NN
HXLJI	JJ
HXLJH	NN
FRIDI	NNT
MLBD	IN
HDGIFH	VB
XFIBWTH	NN
PAPJIH	NNP
HPRNQ	NN
MWEDIM	VB
MMWCET	JJ
FMEW	VB
HZMNWT	NN
ICRW	VB
NTBEIM	NN
DMWQRJIWT	NN
TXIH	NNP
PLIFT	NNT
HQLJWT	NNT
DINMIQH	NN
DWNQL	NNP
HTIIPIIPWT	NN
XLQIIM	JJ
IDM	NN
MWMR	NN
FIRWTIW	NN
FGRIR	NN
RAFLUC	NNP
NTWNWT	VB
HZMINH	VB
HSKMT	NNT
ITBRR	VB
AIJLQI	JJ
QRIAWTIHN	NN
MSTMKT	VB
NXWCIM	JJ
LHLN	RB
ANGLMN	NNP
HSKMH	NN
HSKMI	NNT
LHLK	VB
82	CD
FMXTM	NN
80	CD
81	CD
86	CD
87	JJ
84	CD
85	CD
MWXLJT	JJ
EFIRWT	JJ
MJRIM	NN
BIMH	NN
HLIKIM	NN
JWHR	NNT
BIMT	NNT
DXWSH	JJ
AINDIQCIH	NN
IIDIFAI	JJ
KWLN	PRP
KWLL	VB
NXQR	VB
IFIGW	VB
KWLH	JJ
KWLI	RB
FKNWE	NN
CRPTI	JJ
EFRT	CDT
MTPTXT	VB
MPWRZT	JJ
MIRBI	JJ
XQLAWT	NN
GBET	NNT
IFTWQ	VB
ZRWEW	NN
FKNWT	NN
EWRRNW	VB
WDAWT	NN
FWBTIM	NN
TWQP	NN
LHIPGF	VB
MZH	MOD
NTLTH	VB
CLIINIM	NN
TWQM	VB
TWQN	VB
FAIPWTIW	NN
NWAFW	VB
MXWC	IN
MFJRTI	JJ
EWRPI	JJ
XFDWT	NN
AXWRIT	JJ
QIBLW	VB
NTWNI	NNT
HTPLGWT	NNT
DWDAIM	NN
AXMD	NNP
BJWXIM	VB
NWBL	NNP
PWNQCIH	NN
TIARH	VB
ZIQTH	NN
KIKRWT	NN
LIJA	NNP
MGRF	NN
TTPZR	VB
MWSDI	JJ
REIWNWTIHM	NN
MTWQNWT	JJ
MEWRBWT	NNT
MRWWX	NN
1500	CD
JWNH	NN
GBIIH	NN
MASR	NN
MGDIRH	VB
KRMIAL	NNP
RFWTNW	NN
ZIIDNBRG	NNP
BTWLIM	NN
BWDPFJ	NNP
GWRG	NNP
EIKWB	NNT
PLGI	NNT
EWMQH	NN
LRSN	VB
LJINIWT	JJ
JIPXW	VB
KC	NNP
IRTH	VB
BWLGRI	JJ
RAFWNIWT	JJ
ALWPT	NNT
NERKH	VB
SIPWQ	NN
KK	PRP
BLUL	NNP
KI	COM
KH	RB
HWZMNH	VB
XRDH	NN
KL	DT
KS	NNT
XWQH	NN
HWZMNW	VB
KW	RB
IIGBH	VB
XWQI	NNT
SQJWR	NN
KX	NNT
HMLCWTIH	NN
HWLM	JJ
JKNIWN	NN
HRAL	NNP
1.4	CD
DPWSI	NNT
EMLH	NN
MSWBSD	VB
1.2	CD
1.3	CD
XPCI	NNT
CPCPWT	NN
MWKRIM	JJ
NEWCWT	VB
SQRIM	NN
MPGIFIM	VB
HPNIMW	VB
DBRII	NN
MWSQJRIM	NN
LKRWE	VB
FWTP	NN
ARIQ	NNP
MEBIRIM	VB
SANS	NNP
MWFMET	VB
LHXRIP	VB
MSMLT	VB
XPCW	NN
MXLWT	NN
HLIKI	NNT
NIILWN	NN
LHWDIE	VB
SLZAR	NNP
MPQIE	VB
FGRTIT	JJ
FMWRWT	NNT
MTRWEE	VB
QPRISIN	NNP
BALX	NNP
IZI	NNP
CRNR	NNP
IZM	VB
ALIMWT	NN
MGNJIIM	JJ
XIDWFIM	NN
MRWWIXH	VB
HDRGTI	JJ
ZHIM	JJ
ABXWN	NN
HSTBKWT	NN
49.90	CD
IIDXH	VB
HWDX	VB
HWDW	NNP
QIWM	NN
HTHDRW	VB
IXZQ	VB
MKNH	VB
HWDP	NNT
NGWE	VB
MKNI	JJ
HWDI	JJ
257.5958	CD
NMCAT	VB
JWENIM	VB
JPR	NNP
QWWI	NNT
RWBM	PRP
QLWPIM	JJ
RWBL	NN
MIIJH	NNP
MNHIGWT	NN
SGWLH	JJ
PLWRIDH	NNP
MWRXBWT	JJ
HWGIM	VB
IBWCEW	VB
BGR	VB
MIWXSWT	VB
MTWWDH	VB
MRGIFIM	VB
FBRAWWI	NNP
MWQCH	VB
NIHWLW	NN
MFIX	NN
MPWRJIM	VB
ALWMWT	NNT
BQFH	NN
ZLMN	NNP
MXLIJIM	VB
EMSI	NNP
SQIRWT	NN
MFIJ	NNT
MTPTLT	JJ
MFPJN	NN
KRISJIS	NNP
RWBIN	NNP
RWBIM	NN
MFIM	VB
SIQRN	VB
NIHWLM	NN
LHAFIM	VB
NIHWLH	NN
NIHWLI	JJ
XIC	NN
DNDI	NNP
ZREWNIM	NN
QJINIM	NN
IXWDIIM	JJ
HR	NNT
NHPWK	VB
THH	VB
DISQJIM	NN
NGZRWT	JJ
EWMDIM	VB
MXQRW	NN
DBQW	VB
ZEM	NN
NIN	NNP
LPQD	VB
NIB	NNP
QFIIM	NN
LIIPCIG	NNP
HCGWT	NNT
TPWRSM	VB
TAIM	NN
MWTRWT	NN
KISAW	NN
BLQBWRN	NNP
TCA	VB
KITTI	NN
NIW	NNP
QLIPWTIW	NN
WWIIJNAM	NNP
INQIM	NN
PRJIWT	JJ
HTLWCCW	VB
FDD	VB
FDH	NNT
XBRTIIM	JJ
PNIMIT	JJ
HWAFM	VB
WWLJ	NNP
FDR	NN
032	CD
TMIKWT	NN
031	CD
036	CD
035	CD
PRWQWPIIB	NNP
CIJWJIM	NN
HIKRWT	NN
QJLW	VB
QIDWMM	NN
HEDPT	NNT
MALP	JJ
LWWIIT	NNT
NMKRH	VB
HEDPH	NN
FWBINIZM	NN
MALB	NNP
LCLM	VB
SWPR	NN
HBRIQ	VB
MPQXIM	VB
TQIIM	VB
NSERIM	JJ
MTKXF	VB
EFR	CD
PLJINH	NN
EFW	VB
EFH	VB
SJLINISJIT	JJ
MAZNIIM	NN
JIRWP	NN
TRWPWT	NN
KISWI	NNT
EFN	NN
LIBRH	NN
TRGILI	NNT
FGWIWT	JJ
LHTGBR	VB
MTAIMIM	JJ
MDWBRT	JJ
MFXRIM	VB
BWZR	NNP
HTELLWT	NN
MFPJW	NN
LCD	IN
TTRWM	VB
LEIL	RB
BNWTIW	NN
HTBFRNW	VB
QIISI	NNP
HTKWWNH	VB
SWPH	NN
SWPI	JJ
LFIM	VB
MCDIQH	VB
3791	CD
BASJN	NNP
BRIJIIM	JJ
NHIRIM	JJ
EFRH	CD
BILWI	NN
AINTIPADH	NN
SWPX	VB
SIWR	NN
HBRAT	NNT
MICGI	NNT
QCBAWT	NNT
11,005	CD
PGIFWT	NN
XWBB	NNT
CAWFSQW	NNP
MWSRARH	NNP
PGANI	JJ
HBRAH	NN
NRCX	VB
MXFBIM	NN
04833280	CD
HTREMW	VB
LNGRT	ZVL
CWWTIM	NN
AWBIIQJ	NNT
NTIBWT	NN
MWZRWT	JJ
NPFIIM	JJ
NKNE	VB
DIBWR	NN
IER	NNT
PRIFMN	NNP
NEIMH	JJ
QICN	NNP
XIL	NNT
SWPW	NN
KLIM	NN
XSIDIW	NN
FJWJGARJ	NNP
EIQRIW	NN
LSPWG	VB
MCXIQ	JJ
IED	NN
DISQWNJ	NNP
PINSQI	NNP
HTWWDEH	VB
HRKBT	NNT
RH	MOD
CDN	NN
AIMT	NNT
PLG	NNP
HFBTH	NN
CD	NN
PLD	NNP
MXWFB	JJ
CDQ	NN
PLA	NN
0591	CD
RK	JJ
PLJ	VB
SWLIT	NNT
MNTH	VB
WITWR	NN
FJRI	NNT
FJRN	NNP
FINTH	VB
XLWPIWT	JJ
HPIKH	NN
MDWIQT	JJ
BXR	VB
TIAR	VB
KTIBH	NN
KTIBT	NNT
PRSI	JJ
FBT	NNP
MILWLI	JJ
PRSM	VB
BXN	VB
DWMIH	NN
MJBXIM	NN
SWLIH	NN
FKIX	JJ
PRIJIM	NN
NWCWT	NN
SPRDI	NN
MWESQIM	VB
TLMIDIW	NN
MXQRIIM	JJ
EBRTW	NN
LHIQBR	VB
NEWT	VB
HCBT	NNT
BDIWQ	RB
GRSI	NNP
100,000	CD
LFMF	VB
ERMWN	NNP
QWALICIWT	NN
MTX	NN
ICJMCM	VB
LWWIINI	NNT
SRIQWT	NN
ALBWM	NN
QPCH	VB
QIBH	NN
QIBL	VB
RWPP	JJ
MAWFPZWT	VB
NMRCWT	JJ
ITMQD	VB
MTI	QW
RWPI	NNP
FKJR	NNP
MWDL	NN
BLGIT	JJ
6,592	CD
RWPA	NN
SJIBN	NNP
MINKN	NNP
IFIBWT	NN
LICNIM	NN
MTEBIM	VB
TWARI	NNT
ADWMWT	JJ
LILWT	NN
ARD	NNP
ITKNS	VB
QBWRTW	NN
ARL	NNP
LTETE	VB
HWPKIN	NN
TQDIMIM	NN
MWJI	NNP
NICLIM	VB
MWJL	VB
FQRWQH	NNP
DSJI	NNP
QFWRH	VB
GILAI	NNT
MRWFEWT	JJ
WWIINFJIIN	NNP
EBIRWT	NN
SIETW	NN
NCIG	NNT
HRD	NNP
SICILIH	NNP
MWGBLT	VB
WICMN	NNP
MFPJI	JJ
KDAIWTM	NN
CDDIT	JJ
IWCQIM	VB
IWXNN	NNP
PWLIJIQAIM	NN
FWRFIW	NN
NWEC	VB
LHTRFM	VB
MKWBD	JJ
FLIJT	NNT
NWQPT	VB
MNWDH	VB
PIRSJNRIDR	NNP
LPCWT	VB
AHWBIM	JJ
DMWQRJIH	NN
MGWBFT	JJ
LMTN	VB
EQWRIM	NN
MFTPWT	VB
MRTQT	JJ
MEDKN	VB
NBLEIM	VB
MSIKH	NN
HFMDT	NNT
RCIWNLISJ	NN
RKIFH	NN
SGNWNWT	NN
TRISIM	NN
FIXQNW	VB
MKFWR	NN
HKPFT	NNT
MQWBL	NN
XDIFWT	JJ
IEDIM	NN
HTGLEW	VB
IEDIH	NN
MKFWL	NN
FNIHM	PRP
LBBWT	NN
BTXILH	RB
HXLJT	NNT
HTQPIM	NN
MLBIM	VB
APWD	NNT
HSTKSKNW	VB
ICRNI	NNT
HWMNISJI	JJ
APWA	RB
ICRNW	VB
ZKWIWTIH	NN
NPCEH	VB
110	CD
MFLIM	NN
IDIW	NN
APWR	JJ
WISMWNSQI	NNP
SWCIALIZM	NN
JLWWIZIWNIT	JJ
RKWF	NN
TLWFIM	NN
MAWPQT	JJ
SKSKWK	NN
FIPWR	NNT
MTRISIM	VB
MZRET	NNP
MTKWNNT	VB
FIPWJ	NN
HISJWRI	JJ
MWSLMI	JJ
FIPWC	NNT
WWLSJWN	NNP
TBERH	NN
MCBIEI	NNT
IPTX	VB
SPWRJIWWIT	JJ
FWFLT	NNT
LBNW	NN
LKWDWT	VB
ZHRH	NNP
BARNSLI	NNP
IEBWD	VB
MITRI	NNT
EDIN	JJ
DALAS	NNP
MWJLT	VB
MFWERT	JJ
RWQ	NNP
RWWXIWT	NN
SXWRWT	NN
QMLIWT	NN
LHMTIN	VB
IWNIIJD	NNP
NWFAT	VB
PAFISJIIM	JJ
XWRFIM	VB
MQLXT	NN
RENNH	NNP
QWLJ	VB
QWLT	ZVL
NAMNI	NNT
HWCAW	VB
FQLIM	NN
NXLCW	VB
QWLR	NNT
LRWPP	VB
NWFAI	NNT
NWFAH	NN
34,028	CD
GWRAL	NNP
FMWEWT	NN
LHGID	VB
TMWNWTIW	NN
AQDMIWT	JJ
LHGIB	VB
KTBIW	NN
AHB	VB
MTPTXWT	JJ
TQCIBIIM	JJ
HQPAH	NN
FIRIT	JJ
KTBIM	NN
MBWJXIM	NN
JWPLW	VB
MBWJXIH	NN
RIINGRS	NNP
FHIIH	NN
MELLI	NNT
DINH	NNP
MFMFT	VB
HTENIIN	VB
LWRD	NNP
HCBET	NNT
AINJWNCIH	NN
HQPAT	NNT
LWRM	NNP
SPCIPIWT	JJ
LWRH	NNP
QJIPH	NN
MSWIM	JJ
TWHW	NN
MIWSRIM	JJ
DWL	NNP
XFBH	VB
MSWIG	JJ
ALTWRIM	NN
RXBWT	NNT
LQNWT	VB
ASWPT	NNT
KWRT	VB
GANAJH	NNP
TAILND	NNP
FWWRCQWP	NNP
IIXWDIWT	JJ
ETIQ	JJ
KWRX	NN
IWSIPW	VB
MJPLT	VB
IRAT	NNT
MMMN	VB
AITN	NNP
IGBILW	VB
AITM	NNP
MIWZIQL	NN
MMMF	VB
ZRIQWT	NNT
FNTI	JJ
RDWMIM	JJ
HTXDFWT	NN
MFGIM	NN
MTNWT	NN
ILIDI	NNT
LECWM	VB
LHIMCA	VB
RIALIT	JJ
LECWR	VB
MNGNWNIM	NN
200,000	CD
INWAR	NNP
TIAWRJIT	RB
HQIM	VB
ZIQH	NN
WWIKWX	NN
IDINW	NN
MEWRER	JJ
HPQIEW	VB
GWAIF	NNP
MTPRQT	JJ
EQIP	JJ
DWRSNI	JJ
KHWNH	NN
FINAH	NN
XMH	JJ
XMI	NNT
PIRSWN	NNP
XITTW	NN
RKIFT	NNT
ZIKTH	VB
MJAPISIT	JJ
MINWI	NNT
IESWQ	VB
BNBNIFTI	NNP
MSTKMWT	VB
SWBIIJIT	JJ
LHTPTX	VB
JRIJWRIALIWT	JJ
4,677	CD
MWXLFIM	JJ
KLWMR	RB
IIFPK	VB
TQDIM	NN
FWWDIH	NNP
ZKRWN	NN
FWWDIM	NN
TNWBH	NNP
AWSAQH	NNP
EWBRT	VB
29.9	CD
MSPQT	VB
ZWKR	VB
PILLW	VB
ZKWT	NN
FMWRT	NNT
300,000	CD
IAKLW	VB
ZKWR	NN
MGWWNWT	JJ
AGRSIWWIT	JJ
TTXZH	VB
HTPJRWT	NNT
HTEWRRH	VB
MFTMFT	VB
MAIIMIM	VB
MFWKNEIM	VB
WLSJWN	NNP
FERIM	NN
NFIM	NN
IARGN	VB
HKTMH	NN
MPXIDH	VB
PTRH	VB
NFIT	JJ
NENH	VB
BRZLIWT	NN
LPLWJ	VB
MXWZIWT	JJ
MELWT	NN
